task No.,task_name,start_time,end_time,execution_time,earliest_time,latest_time,resource_load
0,task_0,867,878,11,867,1006,0.005
1,task_1,73,86,13,73,836,0.012
2,task_2,411,416,5,411,1096,0.005
3,task_3,208,214,6,204,1324,0.006
4,task_4,1114,1121,7,1110,1381,0.014
5,task_5,1386,1400,14,1386,1419,0.006
6,task_6,219,231,12,210,1400,0.01
7,task_7,768,773,5,768,893,0.009
8,task_8,539,546,7,539,880,0.011
9,task_9,1129,1137,8,1129,1294,0.007
10,task_10,881,891,10,881,1036,0.009
11,task_11,364,372,8,364,565,0.008
12,task_12,603,609,6,603,1348,0.01
13,task_13,391,396,5,391,420,0.014
14,task_14,144,154,10,144,582,0.013
15,task_15,374,387,13,374,428,0.005
16,task_16,332,342,10,332,750,0.007
17,task_17,897,909,12,896,1053,0.011
18,task_18,529,534,5,528,807,0.01
19,task_19,94,104,10,94,859,0.011
20,task_20,180,190,10,180,1253,0.013
21,task_21,633,639,6,632,1124,0.011
22,task_22,547,556,9,547,743,0.013
23,task_23,1234,1241,7,1234,1303,0.006
24,task_24,1241,1249,8,1046,1436,0.008
25,task_25,945,954,9,945,1046,0.008
26,task_26,36,50,14,36,1360,0.005
27,task_27,778,789,11,778,869,0.014
28,task_28,63,70,7,63,739,0.005
29,task_29,1165,1179,14,1160,1383,0.009
30,task_30,827,840,13,827,1052,0.011
31,task_31,1020,1033,13,1020,1203,0.01
32,task_32,554,563,9,547,1334,0.007
33,task_33,898,904,6,898,1169,0.006
34,task_34,598,606,8,598,1182,0.013
35,task_35,704,718,14,704,993,0.005
36,task_36,407,419,12,407,1318,0.009
37,task_37,465,474,9,465,598,0.006
38,task_38,1114,1124,10,1111,1383,0.009
39,task_39,914,921,7,914,961,0.006
40,task_40,882,890,8,882,929,0.006
41,task_41,82,91,9,82,334,0.005
42,task_42,957,965,8,930,1362,0.013
43,task_43,74,84,10,74,1112,0.01
44,task_44,889,897,8,884,1332,0.014
45,task_45,598,612,14,597,1379,0.014
46,task_46,229,235,6,229,1382,0.005
47,task_47,142,147,5,142,330,0.01
48,task_48,937,945,8,937,1239,0.008
49,task_49,516,524,8,496,1285,0.012
50,task_50,905,912,7,899,1318,0.012
51,task_51,192,200,8,192,590,0.012
52,task_52,1027,1038,11,1025,1297,0.012
53,task_53,291,305,14,291,578,0.014
54,task_54,415,426,11,415,450,0.009
55,task_55,725,734,9,725,856,0.006
56,task_56,380,390,10,380,467,0.006
57,task_57,1183,1197,14,1182,1342,0.008
58,task_58,1085,1094,9,1085,1284,0.014
59,task_59,1161,1172,11,1161,1341,0.012
60,task_60,827,838,11,827,928,0.012
61,task_61,333,339,6,333,576,0.014
62,task_62,19,27,8,19,472,0.01
63,task_63,113,118,5,113,538,0.007
64,task_64,739,752,13,738,946,0.006
65,task_65,1192,1203,11,1192,1271,0.012
66,task_66,694,700,6,694,734,0.007
67,task_67,276,290,14,276,689,0.014
68,task_68,1265,1278,13,1265,1326,0.006
69,task_69,5,11,6,5,1133,0.013
70,task_70,1261,1274,13,1261,1310,0.008
71,task_71,1325,1339,14,1322,1433,0.005
72,task_72,492,505,13,491,1036,0.012
73,task_73,771,780,9,771,1140,0.012
74,task_74,928,933,5,927,1211,0.011
75,task_75,339,345,6,339,1096,0.006
76,task_76,938,943,5,932,1275,0.008
77,task_77,280,290,10,280,713,0.007
78,task_78,312,323,11,311,1313,0.007
79,task_79,662,674,12,662,923,0.01
80,task_80,315,326,11,314,1249,0.01
81,task_81,1378,1390,12,1375,1434,0.01
82,task_82,804,813,9,804,890,0.014
83,task_83,122,127,5,122,849,0.006
84,task_84,320,334,14,320,532,0.009
85,task_85,389,397,8,389,1120,0.014
86,task_86,1011,1016,5,1010,1412,0.011
87,task_87,442,451,9,442,944,0.008
88,task_88,1399,1405,6,1395,1436,0.01
89,task_89,648,662,14,648,1133,0.007
90,task_90,876,883,7,876,1119,0.007
91,task_91,792,804,12,788,1125,0.014
92,task_92,1320,1330,10,1313,1429,0.006
93,task_93,474,480,6,474,1412,0.005
94,task_94,415,429,14,415,1256,0.01
95,task_95,998,1011,13,998,1318,0.005
96,task_96,38,44,6,38,476,0.009
97,task_97,1133,1139,6,1133,1165,0.011
98,task_98,1012,1022,10,1012,1146,0.011
99,task_99,104,115,11,102,797,0.008
100,task_100,1094,1105,11,1093,1332,0.012
101,task_101,686,694,8,658,1422,0.006
102,task_102,1374,1386,12,1374,1417,0.011
103,task_103,16,24,8,16,125,0.011
104,task_104,839,853,14,839,1260,0.005
105,task_105,1070,1080,10,1070,1411,0.011
106,task_106,1073,1081,8,1072,1295,0.005
107,task_107,907,913,6,907,1060,0.007
108,task_108,1140,1146,6,1140,1271,0.01
109,task_109,182,192,10,182,212,0.006
110,task_110,380,387,7,380,435,0.007
111,task_111,510,517,7,510,884,0.013
112,task_112,973,985,12,972,1297,0.008
113,task_113,1007,1020,13,1007,1322,0.005
114,task_114,817,830,13,817,1207,0.011
115,task_115,797,806,9,794,1150,0.006
116,task_116,1247,1259,12,1247,1369,0.007
117,task_117,963,970,7,829,1409,0.007
118,task_118,1248,1256,8,1248,1401,0.007
119,task_119,440,453,13,440,591,0.014
120,task_120,367,375,8,363,1235,0.01
121,task_121,64,72,8,64,478,0.014
122,task_122,152,164,12,152,242,0.006
123,task_123,1221,1231,10,1221,1261,0.011
124,task_124,1027,1038,11,1025,1298,0.005
125,task_125,55,63,8,55,1208,0.01
126,task_126,1063,1074,11,1063,1212,0.012
127,task_127,967,976,9,967,1048,0.014
128,task_128,1297,1304,7,1297,1377,0.006
129,task_129,764,778,14,764,1045,0.011
130,task_130,1179,1192,13,1179,1318,0.007
131,task_131,1309,1323,14,1309,1335,0.012
132,task_132,895,901,6,895,964,0.013
133,task_133,311,325,14,310,574,0.012
134,task_134,272,279,7,272,1258,0.006
135,task_135,248,258,10,248,293,0.006
136,task_136,251,260,9,251,909,0.005
137,task_137,819,830,11,818,1315,0.005
138,task_138,835,842,7,835,928,0.01
139,task_139,1085,1096,11,1085,1155,0.01
140,task_140,276,287,11,276,1342,0.011
141,task_141,350,355,5,350,636,0.006
142,task_142,615,623,8,613,1242,0.007
143,task_143,1177,1191,14,1174,1412,0.014
144,task_144,926,932,6,911,1404,0.007
145,task_145,1301,1308,7,1265,1422,0.013
146,task_146,833,842,9,830,1112,0.013
147,task_147,1273,1281,8,1273,1301,0.013
148,task_148,1131,1138,7,1131,1369,0.014
149,task_149,683,696,13,682,1185,0.005
150,task_150,532,543,11,532,1010,0.013
151,task_151,716,726,10,716,1056,0.006
152,task_152,143,150,7,143,1200,0.008
153,task_153,451,458,7,451,1072,0.008
154,task_154,1191,1201,10,1188,1340,0.006
155,task_155,365,376,11,364,882,0.013
156,task_156,624,638,14,608,1416,0.011
157,task_157,726,731,5,725,1381,0.007
158,task_158,736,750,14,736,1367,0.014
159,task_159,415,426,11,415,695,0.013
160,task_160,52,64,12,52,559,0.011
161,task_161,1053,1064,11,1053,1231,0.011
162,task_162,486,494,8,485,839,0.011
163,task_163,647,658,11,647,767,0.014
164,task_164,375,388,13,375,694,0.011
165,task_165,237,243,6,237,662,0.009
166,task_166,815,824,9,800,1329,0.005
167,task_167,652,664,12,651,1036,0.011
168,task_168,1003,1008,5,1003,1208,0.008
169,task_169,767,774,7,765,1352,0.008
170,task_170,1133,1141,8,1133,1169,0.005
171,task_171,155,164,9,155,553,0.011
172,task_172,513,526,13,512,1131,0.012
173,task_173,1347,1359,12,1347,1386,0.01
174,task_174,239,251,12,238,466,0.009
175,task_175,1067,1080,13,1067,1245,0.014
176,task_176,418,430,12,418,896,0.009
177,task_177,170,182,12,170,1220,0.011
178,task_178,1210,1223,13,1210,1398,0.008
179,task_179,1195,1209,14,1193,1363,0.01
180,task_180,1350,1362,12,1299,1439,0.012
181,task_181,885,897,12,885,949,0.007
182,task_182,1382,1387,5,1380,1435,0.008
183,task_183,493,499,6,493,540,0.01
184,task_184,164,176,12,163,1347,0.012
185,task_185,109,114,5,109,679,0.006
186,task_186,1108,1119,11,1108,1145,0.012
187,task_187,873,881,8,873,1376,0.014
188,task_188,36,46,10,36,928,0.007
189,task_189,1219,1229,10,1219,1287,0.008
190,task_190,560,571,11,560,771,0.011
191,task_191,325,334,9,325,751,0.013
192,task_192,48,56,8,48,1205,0.011
193,task_193,490,503,13,490,1205,0.007
194,task_194,878,884,6,877,1379,0.01
195,task_195,1194,1199,5,1194,1311,0.01
196,task_196,534,546,12,518,1366,0.007
197,task_197,1073,1086,13,1028,1420,0.013
198,task_198,724,733,9,724,1182,0.005
199,task_199,1253,1261,8,1253,1397,0.006
200,task_200,434,444,10,434,472,0.009
201,task_201,465,474,9,465,1218,0.014
202,task_202,1328,1342,14,1311,1436,0.005
203,task_203,236,250,14,193,1438,0.012
204,task_204,638,652,14,637,859,0.006
205,task_205,754,762,8,754,912,0.01
206,task_206,679,691,12,679,1307,0.013
207,task_207,715,723,8,715,1127,0.009
208,task_208,309,320,11,309,522,0.012
209,task_209,1389,1394,5,1389,1416,0.013
210,task_210,983,990,7,983,1000,0.014
211,task_211,1388,1395,7,1388,1420,0.005
212,task_212,634,646,12,632,1345,0.009
213,task_213,706,719,13,706,1070,0.011
214,task_214,1392,1405,13,1392,1423,0.006
215,task_215,1037,1043,6,1037,1325,0.009
216,task_216,770,779,9,650,1433,0.008
217,task_217,923,937,14,918,1240,0.014
218,task_218,354,368,14,351,1117,0.005
219,task_219,1041,1055,14,1041,1141,0.009
220,task_220,776,785,9,776,1027,0.009
221,task_221,1202,1212,10,1202,1226,0.007
222,task_222,1146,1151,5,1146,1183,0.01
223,task_223,567,580,13,555,1286,0.011
224,task_224,671,681,10,665,1328,0.013
225,task_225,1248,1260,12,1248,1321,0.012
226,task_226,942,953,11,941,1309,0.013
227,task_227,558,564,6,558,665,0.011
228,task_228,931,942,11,930,1083,0.014
229,task_229,1006,1019,13,1006,1254,0.006
230,task_230,1351,1362,11,1351,1429,0.012
231,task_231,1262,1269,7,1258,1374,0.009
232,task_232,926,939,13,926,1062,0.006
233,task_233,1086,1091,5,1084,1305,0.013
234,task_234,1043,1056,13,1043,1267,0.006
235,task_235,69,78,9,69,494,0.006
236,task_236,305,316,11,305,647,0.006
237,task_237,961,974,13,961,1066,0.006
238,task_238,1350,1355,5,1350,1424,0.005
239,task_239,883,897,14,880,1234,0.009
240,task_240,656,669,13,655,1184,0.006
241,task_241,1261,1266,5,1258,1369,0.006
242,task_242,223,229,6,223,401,0.014
243,task_243,595,600,5,595,737,0.006
244,task_244,529,538,9,526,1329,0.011
245,task_245,627,632,5,625,1322,0.008
246,task_246,592,597,5,590,1310,0.012
247,task_247,706,718,12,706,776,0.006
248,task_248,13,25,12,13,347,0.012
249,task_249,926,933,7,926,1136,0.01
250,task_250,1309,1316,7,1309,1343,0.009
251,task_251,25,34,9,24,1400,0.007
252,task_252,1181,1188,7,841,1426,0.013
253,task_253,24,35,11,22,1109,0.006
254,task_254,693,706,13,693,757,0.01
255,task_255,93,106,13,93,700,0.008
256,task_256,1133,1143,10,1133,1359,0.012
257,task_257,455,469,14,455,981,0.008
258,task_258,751,763,12,750,1263,0.012
259,task_259,1362,1368,6,1361,1428,0.014
260,task_260,42,51,9,42,568,0.009
261,task_261,645,655,10,634,1424,0.013
262,task_262,405,417,12,405,934,0.006
263,task_263,38,43,5,38,607,0.01
264,task_264,881,888,7,881,1111,0.005
265,task_265,1151,1158,7,1145,1411,0.006
266,task_266,743,749,6,743,815,0.014
267,task_267,1025,1035,10,1025,1100,0.006
268,task_268,646,659,13,646,1360,0.01
269,task_269,691,699,8,691,774,0.006
270,task_270,1011,1016,5,1009,1290,0.005
271,task_271,673,679,6,672,945,0.009
272,task_272,299,309,10,298,1146,0.007
273,task_273,592,602,10,592,1285,0.008
274,task_274,1396,1408,12,1395,1433,0.013
275,task_275,1326,1337,11,1318,1432,0.012
276,task_276,1361,1366,5,1361,1411,0.005
277,task_277,1270,1280,10,1268,1390,0.008
278,task_278,674,684,10,674,851,0.009
279,task_279,584,591,7,583,1085,0.009
280,task_280,372,386,14,358,1309,0.013
281,task_281,990,1002,12,990,1113,0.008
282,task_282,58,69,11,58,905,0.012
283,task_283,895,903,8,891,1377,0.013
284,task_284,870,881,11,870,902,0.009
285,task_285,1099,1104,5,1099,1215,0.01
286,task_286,1022,1036,14,1007,1431,0.009
287,task_287,1250,1261,11,1250,1391,0.008
288,task_288,956,964,8,931,1349,0.006
289,task_289,457,466,9,457,1269,0.009
290,task_290,195,208,13,195,557,0.006
291,task_291,638,646,8,638,772,0.014
292,task_292,579,590,11,579,1054,0.006
293,task_293,96,106,10,95,660,0.01
294,task_294,973,983,10,972,1262,0.014
295,task_295,859,871,12,817,1374,0.006
296,task_296,358,371,13,358,540,0.005
297,task_297,641,655,14,641,681,0.012
298,task_298,862,874,12,790,1387,0.009
299,task_299,1344,1351,7,1344,1406,0.008
300,task_300,271,285,14,271,1199,0.013
301,task_301,996,1007,11,996,1313,0.007
302,task_302,773,781,8,773,925,0.01
303,task_303,719,728,9,719,1040,0.008
304,task_304,577,588,11,577,696,0.009
305,task_305,648,662,14,648,1084,0.01
306,task_306,60,67,7,60,731,0.007
307,task_307,1302,1311,9,1279,1425,0.011
308,task_308,1030,1038,8,1030,1172,0.011
309,task_309,658,670,12,658,1023,0.008
310,task_310,817,827,10,817,1235,0.014
311,task_311,81,92,11,81,794,0.009
312,task_312,371,379,8,371,398,0.013
313,task_313,384,393,9,384,464,0.009
314,task_314,453,458,5,453,1296,0.012
315,task_315,1292,1302,10,1292,1373,0.012
316,task_316,846,856,10,843,1244,0.013
317,task_317,1334,1342,8,1334,1381,0.012
318,task_318,1131,1141,10,1131,1210,0.012
319,task_319,561,568,7,561,653,0.006
320,task_320,874,883,9,798,1389,0.01
321,task_321,1017,1029,12,1017,1116,0.011
322,task_322,779,789,10,779,878,0.006
323,task_323,327,337,10,327,1270,0.005
324,task_324,388,401,13,388,505,0.006
325,task_325,439,448,9,439,1261,0.006
326,task_326,570,581,11,570,665,0.011
327,task_327,669,681,12,647,1313,0.012
328,task_328,239,253,14,238,339,0.011
329,task_329,188,196,8,188,1193,0.006
330,task_330,823,836,13,822,1189,0.007
331,task_331,340,354,14,340,419,0.012
332,task_332,950,956,6,950,968,0.013
333,task_333,1299,1307,8,1298,1357,0.012
334,task_334,1176,1181,5,1171,1389,0.013
335,task_335,1353,1362,9,1353,1383,0.011
336,task_336,902,912,10,902,1067,0.013
337,task_337,925,939,14,892,1405,0.012
338,task_338,267,275,8,267,322,0.012
339,task_339,736,748,12,736,1237,0.008
340,task_340,386,399,13,386,795,0.014
341,task_341,66,75,9,66,468,0.007
342,task_342,1059,1066,7,1058,1291,0.009
343,task_343,759,765,6,759,1054,0.006
344,task_344,1384,1397,13,1384,1430,0.01
345,task_345,429,436,7,429,1307,0.006
346,task_346,903,915,12,901,1247,0.014
347,task_347,40,48,8,40,962,0.011
348,task_348,1042,1051,9,1042,1100,0.007
349,task_349,240,251,11,240,842,0.007
350,task_350,80,87,7,80,1401,0.011
351,task_351,685,691,6,671,1373,0.011
352,task_352,1295,1304,9,1295,1383,0.01
353,task_353,1229,1235,6,1229,1283,0.013
354,task_354,1194,1201,7,1194,1237,0.013
355,task_355,686,692,6,686,1386,0.01
356,task_356,87,99,12,85,749,0.009
357,task_357,333,342,9,333,752,0.006
358,task_358,1293,1302,9,1291,1414,0.011
359,task_359,1082,1096,14,1082,1141,0.013
360,task_360,1194,1202,8,1192,1353,0.008
361,task_361,934,939,5,930,1246,0.014
362,task_362,1256,1267,11,1256,1295,0.013
363,task_363,1241,1249,8,1231,1436,0.006
364,task_364,107,121,14,107,336,0.005
365,task_365,1222,1230,8,1221,1340,0.008
366,task_366,723,733,10,702,1357,0.014
367,task_367,361,369,8,361,731,0.009
368,task_368,920,926,6,918,962,0.009
369,task_369,471,478,7,471,611,0.012
370,task_370,193,206,13,193,343,0.009
371,task_371,764,774,10,764,1178,0.01
372,task_372,794,801,7,794,816,0.013
373,task_373,1043,1048,5,1040,1331,0.008
374,task_374,745,759,14,745,982,0.007
375,task_375,1014,1023,9,1014,1161,0.005
376,task_376,790,798,8,790,959,0.007
377,task_377,57,64,7,57,670,0.005
378,task_378,1264,1270,6,1264,1288,0.006
379,task_379,645,652,7,591,1434,0.009
380,task_380,161,169,8,161,1388,0.005
381,task_381,85,91,6,85,366,0.008
382,task_382,1281,1287,6,1281,1310,0.011
383,task_383,628,640,12,624,1421,0.014
384,task_384,37,46,9,37,1387,0.01
385,task_385,551,560,9,551,914,0.013
386,task_386,862,876,14,862,1290,0.006
387,task_387,65,73,8,61,1423,0.007
388,task_388,209,222,13,209,1259,0.008
389,task_389,36,44,8,36,107,0.01
390,task_390,528,542,14,528,697,0.005
391,task_391,963,971,8,963,1068,0.01
392,task_392,785,798,13,785,1043,0.008
393,task_393,55,64,9,55,1430,0.005
394,task_394,1217,1228,11,1217,1375,0.006
395,task_395,436,448,12,436,494,0.011
396,task_396,1177,1188,11,1177,1243,0.011
397,task_397,1061,1067,6,1061,1127,0.013
398,task_398,1241,1251,10,930,1438,0.009
399,task_399,746,759,13,746,1256,0.013
400,task_400,1142,1153,11,1142,1170,0.011
401,task_401,746,757,11,746,811,0.009
402,task_402,1166,1173,7,1154,1407,0.014
403,task_403,1189,1199,10,1189,1231,0.009
404,task_404,1042,1050,8,1042,1182,0.014
405,task_405,548,561,13,547,1064,0.014
406,task_406,1278,1286,8,1277,1399,0.008
407,task_407,897,907,10,897,962,0.006
408,task_408,1254,1266,12,1254,1338,0.005
409,task_409,969,974,5,969,1274,0.012
410,task_410,576,586,10,576,1092,0.007
411,task_411,1081,1086,5,1080,1379,0.005
412,task_412,1267,1273,6,1263,1393,0.005
413,task_413,369,375,6,369,937,0.013
414,task_414,809,816,7,808,1052,0.008
415,task_415,699,707,8,699,833,0.006
416,task_416,252,259,7,252,1202,0.012
417,task_417,612,622,10,612,768,0.01
418,task_418,676,686,10,676,1247,0.007
419,task_419,1166,1176,10,1166,1348,0.011
420,task_420,873,879,6,873,1236,0.005
421,task_421,1324,1337,13,1323,1385,0.008
422,task_422,256,266,10,256,333,0.01
423,task_423,362,375,13,362,508,0.013
424,task_424,1338,1349,11,1335,1416,0.005
425,task_425,1284,1297,13,1283,1348,0.009
426,task_426,42,55,13,42,163,0.01
427,task_427,1351,1364,13,1351,1412,0.008
428,task_428,1356,1366,10,1356,1388,0.009
429,task_429,925,933,8,925,1249,0.011
430,task_430,655,663,8,655,1046,0.005
431,task_431,250,258,8,250,501,0.006
432,task_432,1060,1073,13,1060,1245,0.011
433,task_433,1099,1112,13,1099,1164,0.01
434,task_434,664,678,14,660,1307,0.008
435,task_435,328,333,5,328,729,0.006
436,task_436,713,725,12,710,1211,0.009
437,task_437,1336,1343,7,1336,1356,0.008
438,task_438,181,186,5,181,1270,0.008
439,task_439,229,243,14,229,589,0.005
440,task_440,683,696,13,683,905,0.008
441,task_441,1076,1088,12,967,1429,0.011
442,task_442,1330,1338,8,1330,1356,0.006
443,task_443,940,948,8,940,1042,0.01
444,task_444,826,833,7,826,1067,0.013
445,task_445,1213,1218,5,1213,1348,0.007
446,task_446,48,54,6,48,1232,0.005
447,task_447,90,96,6,90,935,0.011
448,task_448,529,536,7,524,1331,0.007
449,task_449,1075,1080,5,1075,1398,0.009
450,task_450,476,486,10,476,1039,0.008
451,task_451,1024,1030,6,1024,1163,0.009
452,task_452,1081,1091,10,1077,1383,0.008
453,task_453,302,316,14,302,1005,0.009
454,task_454,304,310,6,304,688,0.007
455,task_455,283,289,6,283,1172,0.012
456,task_456,1354,1359,5,1354,1416,0.007
457,task_457,363,374,11,363,576,0.005
458,task_458,757,768,11,757,812,0.006
459,task_459,821,827,6,821,922,0.01
460,task_460,605,615,10,592,1433,0.014
461,task_461,328,339,11,328,671,0.009
462,task_462,330,335,5,330,1023,0.011
463,task_463,419,433,14,419,1431,0.014
464,task_464,1,9,8,1,1088,0.009
465,task_465,260,272,12,260,483,0.008
466,task_466,623,633,10,623,1354,0.009
467,task_467,1337,1347,10,1337,1363,0.009
468,task_468,1362,1369,7,972,1439,0.014
469,task_469,249,255,6,249,1261,0.005
470,task_470,259,268,9,259,999,0.012
471,task_471,285,294,9,285,986,0.01
472,task_472,1034,1039,5,1033,1148,0.006
473,task_473,364,374,10,364,472,0.006
474,task_474,123,136,13,123,688,0.012
475,task_475,1212,1219,7,1212,1273,0.012
476,task_476,1043,1053,10,1040,1301,0.01
477,task_477,397,407,10,397,664,0.009
478,task_478,94,108,14,94,161,0.013
479,task_479,1246,1254,8,1246,1265,0.014
480,task_480,300,305,5,300,746,0.01
481,task_481,379,390,11,379,982,0.008
482,task_482,173,182,9,172,1011,0.008
483,task_483,861,869,8,818,1376,0.014
484,task_484,1327,1341,14,1327,1407,0.011
485,task_485,1376,1388,12,1376,1423,0.01
486,task_486,438,445,7,438,545,0.007
487,task_487,1140,1152,12,1140,1250,0.013
488,task_488,485,498,13,485,842,0.01
489,task_489,739,751,12,738,867,0.012
490,task_490,754,759,5,754,890,0.011
491,task_491,1145,1153,8,1144,1282,0.014
492,task_492,433,439,6,433,512,0.008
493,task_493,500,512,12,500,722,0.005
494,task_494,362,373,11,362,1144,0.009
495,task_495,1164,1175,11,1164,1321,0.014
496,task_496,961,969,8,961,1133,0.006
497,task_497,100,114,14,100,871,0.006
498,task_498,86,93,7,85,662,0.006
499,task_499,718,726,8,709,1327,0.01
500,task_500,732,744,12,732,1097,0.011
501,task_501,763,773,10,763,938,0.01
502,task_502,809,818,9,808,1146,0.014
503,task_503,620,626,6,620,912,0.009
504,task_504,215,223,8,215,708,0.008
505,task_505,1193,1202,9,1193,1294,0.01
506,task_506,1011,1022,11,886,1425,0.013
507,task_507,158,163,5,158,1311,0.013
508,task_508,1350,1356,6,1350,1423,0.012
509,task_509,34,46,12,34,986,0.011
510,task_510,1229,1237,8,1229,1341,0.01
511,task_511,709,723,14,705,1294,0.013
512,task_512,349,363,14,348,1383,0.009
513,task_513,1401,1406,5,1380,1438,0.011
514,task_514,493,507,14,485,1261,0.014
515,task_515,602,612,10,507,1429,0.006
516,task_516,456,464,8,456,1389,0.005
517,task_517,1386,1399,13,1386,1417,0.006
518,task_518,370,380,10,370,767,0.009
519,task_519,518,526,8,518,704,0.008
520,task_520,1017,1024,7,1017,1216,0.014
521,task_521,730,737,7,730,1081,0.012
522,task_522,1227,1233,6,1227,1267,0.014
523,task_523,1265,1274,9,1265,1328,0.006
524,task_524,1023,1037,14,1023,1182,0.01
525,task_525,699,704,5,696,1255,0.013
526,task_526,409,419,10,408,1177,0.008
527,task_527,913,923,10,913,964,0.006
528,task_528,240,247,7,238,1334,0.007
529,task_529,552,565,13,552,957,0.005
530,task_530,653,663,10,649,1103,0.011
531,task_531,617,630,13,617,984,0.014
532,task_532,1313,1320,7,1313,1355,0.013
533,task_533,196,205,9,196,236,0.008
534,task_534,1327,1340,13,1327,1413,0.013
535,task_535,138,148,10,137,1226,0.014
536,task_536,956,970,14,956,1062,0.006
537,task_537,1191,1196,5,1191,1342,0.013
538,task_538,943,955,12,942,1331,0.012
539,task_539,132,145,13,130,1240,0.014
540,task_540,1400,1405,5,1397,1435,0.008
541,task_541,1320,1329,9,1320,1367,0.007
542,task_542,1016,1026,10,990,1424,0.012
543,task_543,323,336,13,323,1108,0.011
544,task_544,1307,1320,13,1304,1387,0.008
545,task_545,949,956,7,949,1120,0.011
546,task_546,1038,1045,7,1038,1204,0.005
547,task_547,18,31,13,18,78,0.009
548,task_548,209,218,9,208,1361,0.014
549,task_549,71,77,6,71,655,0.012
550,task_550,503,512,9,503,1067,0.01
551,task_551,402,413,11,401,1425,0.005
552,task_552,627,639,12,627,1197,0.014
553,task_553,198,207,9,197,1221,0.013
554,task_554,922,931,9,922,1069,0.008
555,task_555,556,567,11,556,743,0.011
556,task_556,88,95,7,88,823,0.012
557,task_557,1365,1377,12,1365,1400,0.007
558,task_558,711,723,12,711,769,0.01
559,task_559,731,739,8,728,1413,0.005
560,task_560,397,406,9,396,1074,0.007
561,task_561,1001,1014,13,988,1398,0.01
562,task_562,1053,1059,6,1053,1077,0.01
563,task_563,1382,1389,7,1378,1439,0.007
564,task_564,1051,1058,7,1031,1373,0.012
565,task_565,208,221,13,192,1334,0.008
566,task_566,77,85,8,77,966,0.006
567,task_567,1151,1157,6,1147,1405,0.009
568,task_568,198,204,6,197,1271,0.013
569,task_569,1041,1055,14,1041,1177,0.005
570,task_570,798,811,13,798,1057,0.007
571,task_571,558,567,9,558,647,0.005
572,task_572,470,476,6,470,790,0.008
573,task_573,1231,1238,7,1231,1394,0.006
574,task_574,1388,1398,10,1388,1436,0.013
575,task_575,610,622,12,610,978,0.014
576,task_576,639,644,5,639,702,0.014
577,task_577,703,708,5,701,796,0.005
578,task_578,1157,1167,10,1155,1268,0.014
579,task_579,260,271,11,260,1421,0.009
580,task_580,1065,1079,14,1051,1407,0.009
581,task_581,774,779,5,772,1195,0.005
582,task_582,867,880,13,867,1214,0.012
583,task_583,1260,1266,6,1259,1356,0.01
584,task_584,826,838,12,826,965,0.01
585,task_585,275,287,12,275,641,0.009
586,task_586,841,851,10,841,1303,0.005
587,task_587,438,449,11,438,783,0.013
588,task_588,1291,1298,7,1291,1347,0.007
589,task_589,1352,1358,6,1352,1416,0.007
590,task_590,63,73,10,62,598,0.012
591,task_591,580,586,6,538,1391,0.006
592,task_592,484,490,6,484,854,0.014
593,task_593,703,716,13,702,828,0.005
594,task_594,872,878,6,871,1199,0.01
595,task_595,991,998,7,991,1174,0.01
596,task_596,1219,1225,6,908,1430,0.007
597,task_597,333,345,12,333,719,0.013
598,task_598,1106,1117,11,1101,1387,0.014
599,task_599,101,107,6,101,1409,0.011
600,task_600,642,655,13,642,1284,0.005
601,task_601,498,509,11,494,1126,0.009
602,task_602,292,301,9,292,752,0.014
603,task_603,1091,1103,12,1091,1201,0.012
604,task_604,643,650,7,643,886,0.012
605,task_605,874,883,9,874,1374,0.012
606,task_606,1093,1101,8,1093,1131,0.011
607,task_607,1099,1113,14,1098,1278,0.014
608,task_608,449,456,7,449,816,0.007
609,task_609,792,802,10,792,1222,0.012
610,task_610,2,14,12,2,65,0.005
611,task_611,465,472,7,465,885,0.012
612,task_612,935,940,5,935,1035,0.008
613,task_613,379,388,9,379,758,0.013
614,task_614,654,664,10,652,1142,0.011
615,task_615,816,829,13,813,1340,0.013
616,task_616,1001,1006,5,1000,1250,0.014
617,task_617,212,221,9,210,1058,0.009
618,task_618,189,203,14,189,1200,0.014
619,task_619,1086,1099,13,1084,1294,0.014
620,task_620,397,407,10,395,1033,0.014
621,task_621,355,361,6,355,949,0.006
622,task_622,774,785,11,774,834,0.013
623,task_623,1329,1341,12,1270,1434,0.012
624,task_624,596,602,6,596,996,0.011
625,task_625,972,983,11,972,1052,0.008
626,task_626,1237,1251,14,1237,1328,0.011
627,task_627,883,895,12,882,1161,0.014
628,task_628,734,746,12,732,1387,0.01
629,task_629,373,384,11,362,1342,0.01
630,task_630,1132,1137,5,1132,1395,0.012
631,task_631,307,315,8,302,1309,0.014
632,task_632,32,45,13,32,1281,0.007
633,task_633,477,489,12,477,1024,0.012
634,task_634,25,30,5,25,776,0.007
635,task_635,339,351,12,339,502,0.01
636,task_636,845,854,9,844,1220,0.008
637,task_637,1165,1176,11,1159,1352,0.012
638,task_638,1201,1208,7,1201,1307,0.005
639,task_639,234,240,6,233,901,0.012
640,task_640,809,816,7,808,1262,0.007
641,task_641,1080,1092,12,1078,1280,0.013
642,task_642,1105,1114,9,1099,1357,0.011
643,task_643,829,837,8,828,1176,0.008
644,task_644,258,266,8,258,321,0.01
645,task_645,1108,1113,5,1108,1155,0.006
646,task_646,1290,1302,12,1290,1340,0.007
647,task_647,952,959,7,935,1340,0.006
648,task_648,520,525,5,520,568,0.006
649,task_649,214,225,11,214,397,0.012
650,task_650,128,134,6,128,175,0.008
651,task_651,1022,1035,13,810,1429,0.012
652,task_652,813,821,8,801,1308,0.006
653,task_653,959,973,14,959,1309,0.007
654,task_654,368,377,9,368,519,0.005
655,task_655,759,772,13,759,1018,0.013
656,task_656,278,288,10,277,1025,0.014
657,task_657,151,158,7,151,829,0.01
658,task_658,372,380,8,372,724,0.013
659,task_659,1057,1064,7,1057,1100,0.005
660,task_660,414,424,10,413,1233,0.005
661,task_661,1249,1254,5,1249,1297,0.012
662,task_662,25,31,6,21,1214,0.01
663,task_663,1101,1111,10,1100,1287,0.014
664,task_664,584,589,5,583,1002,0.014
665,task_665,823,832,9,820,1126,0.006
666,task_666,951,961,10,951,1302,0.009
667,task_667,1233,1240,7,1233,1334,0.007
668,task_668,365,370,5,365,900,0.005
669,task_669,143,148,5,143,819,0.014
670,task_670,5,10,5,5,143,0.01
671,task_671,479,490,11,479,1176,0.013
672,task_672,823,837,14,820,1190,0.005
673,task_673,965,975,10,965,1001,0.008
674,task_674,914,925,11,913,1376,0.014
675,task_675,1260,1273,13,1259,1340,0.013
676,task_676,1219,1231,12,1219,1319,0.005
677,task_677,1143,1153,10,1141,1400,0.005
678,task_678,1141,1150,9,1141,1233,0.01
679,task_679,411,419,8,411,1061,0.01
680,task_680,676,684,8,674,1161,0.01
681,task_681,423,437,14,423,940,0.005
682,task_682,1300,1311,11,1264,1421,0.009
683,task_683,733,746,13,733,1172,0.008
684,task_684,954,968,14,954,1197,0.009
685,task_685,1334,1341,7,1334,1383,0.01
686,task_686,698,711,13,697,1002,0.01
687,task_687,1215,1223,8,1215,1328,0.014
688,task_688,70,75,5,70,832,0.006
689,task_689,670,678,8,670,1300,0.012
690,task_690,387,395,8,387,423,0.006
691,task_691,507,521,14,507,602,0.014
692,task_692,1385,1396,11,1385,1423,0.01
693,task_693,997,1005,8,996,1373,0.012
694,task_694,105,115,10,104,959,0.007
695,task_695,746,757,11,746,959,0.009
696,task_696,157,167,10,157,857,0.006
697,task_697,53,63,10,53,244,0.006
698,task_698,125,130,5,121,854,0.014
699,task_699,1211,1221,10,1210,1417,0.013
700,task_700,580,587,7,524,1387,0.008
701,task_701,1212,1221,9,1212,1380,0.01
702,task_702,1300,1314,14,1300,1386,0.007
703,task_703,461,474,13,461,1038,0.012
704,task_704,548,562,14,547,1006,0.013
705,task_705,1135,1145,10,1134,1227,0.008
706,task_706,156,167,11,156,458,0.008
707,task_707,345,351,6,345,1283,0.005
708,task_708,1233,1241,8,792,1434,0.012
709,task_709,952,961,9,945,1341,0.013
710,task_710,1390,1403,13,1390,1428,0.008
711,task_711,1182,1195,13,1182,1314,0.005
712,task_712,1067,1073,6,1067,1381,0.007
713,task_713,315,323,8,315,866,0.007
714,task_714,161,168,7,161,721,0.011
715,task_715,718,728,10,694,1323,0.011
716,task_716,854,859,5,854,1157,0.008
717,task_717,162,170,8,162,1077,0.013
718,task_718,288,298,10,288,1306,0.007
719,task_719,64,77,13,64,517,0.011
720,task_720,452,457,5,452,1200,0.012
721,task_721,1118,1129,11,1118,1253,0.008
722,task_722,1184,1194,10,844,1429,0.012
723,task_723,1007,1019,12,1005,1414,0.006
724,task_724,1381,1387,6,1375,1431,0.008
725,task_725,996,1010,14,996,1130,0.013
726,task_726,648,656,8,648,1157,0.014
727,task_727,78,86,8,78,1360,0.013
728,task_728,1095,1105,10,1090,1389,0.006
729,task_729,459,466,7,459,497,0.012
730,task_730,293,300,7,293,375,0.007
731,task_731,810,818,8,810,992,0.01
732,task_732,1311,1321,10,1311,1418,0.007
733,task_733,1065,1078,13,1055,1404,0.007
734,task_734,581,587,6,581,899,0.005
735,task_735,969,974,5,969,1030,0.012
736,task_736,36,46,10,36,131,0.011
737,task_737,312,322,10,311,1203,0.008
738,task_738,303,312,9,303,613,0.013
739,task_739,331,345,14,331,1270,0.007
740,task_740,112,125,13,112,589,0.005
741,task_741,235,249,14,235,698,0.014
742,task_742,805,817,12,801,1262,0.005
743,task_743,1172,1179,7,1169,1301,0.013
744,task_744,1400,1408,8,1399,1439,0.005
745,task_745,946,952,6,946,984,0.005
746,task_746,1292,1301,9,1292,1363,0.007
747,task_747,301,312,11,301,737,0.009
748,task_748,691,704,13,690,973,0.008
749,task_749,1399,1408,9,1398,1436,0.007
750,task_750,37,49,12,37,1203,0.011
751,task_751,540,551,11,540,969,0.014
752,task_752,829,838,9,828,1070,0.008
753,task_753,145,158,13,145,1097,0.006
754,task_754,347,359,12,347,1216,0.013
755,task_755,1159,1166,7,1159,1232,0.007
756,task_756,819,830,11,819,1059,0.01
757,task_757,200,213,13,200,585,0.014
758,task_758,939,947,8,932,1321,0.014
759,task_759,480,487,7,480,1192,0.013
760,task_760,674,684,10,672,986,0.013
761,task_761,829,842,13,829,1099,0.006
762,task_762,703,715,12,702,745,0.009
763,task_763,251,258,7,251,505,0.01
764,task_764,893,905,12,893,928,0.013
765,task_765,195,208,13,195,924,0.006
766,task_766,100,111,11,100,548,0.006
767,task_767,1055,1065,10,1055,1102,0.013
768,task_768,726,739,13,692,1382,0.007
769,task_769,318,323,5,318,1100,0.012
770,task_770,548,558,10,548,855,0.012
771,task_771,459,465,6,459,1394,0.008
772,task_772,258,267,9,258,392,0.008
773,task_773,1036,1046,10,1033,1273,0.008
774,task_774,1267,1273,6,1263,1380,0.014
775,task_775,1254,1262,8,1254,1305,0.01
776,task_776,578,590,12,577,1060,0.012
777,task_777,57,69,12,57,352,0.008
778,task_778,376,388,12,376,914,0.005
779,task_779,256,269,13,256,1343,0.01
780,task_780,1074,1080,6,1034,1416,0.013
781,task_781,92,105,13,92,1179,0.008
782,task_782,548,553,5,547,1221,0.011
783,task_783,75,87,12,75,865,0.007
784,task_784,496,506,10,495,1071,0.008
785,task_785,1061,1067,6,1061,1145,0.007
786,task_786,860,872,12,860,1323,0.012
787,task_787,435,440,5,435,1297,0.005
788,task_788,348,361,13,348,846,0.008
789,task_789,508,516,8,508,541,0.011
790,task_790,1046,1059,13,1046,1281,0.013
791,task_791,406,416,10,404,1191,0.005
792,task_792,246,255,9,246,394,0.013
793,task_793,353,365,12,353,973,0.013
794,task_794,1231,1244,13,1231,1265,0.01
795,task_795,1139,1144,5,1139,1182,0.005
796,task_796,431,441,10,431,1117,0.008
797,task_797,1038,1045,7,1038,1140,0.014
798,task_798,577,585,8,577,686,0.011
799,task_799,965,976,11,964,1282,0.007
800,task_800,897,908,11,896,1130,0.012
801,task_801,829,841,12,828,1045,0.011
802,task_802,554,567,13,547,1340,0.009
803,task_803,991,997,6,991,1065,0.011
804,task_804,209,222,13,208,1347,0.006
805,task_805,429,441,12,429,485,0.009
806,task_806,756,761,5,756,1233,0.007
807,task_807,667,676,9,665,1027,0.008
808,task_808,479,486,7,479,739,0.012
809,task_809,499,505,6,499,936,0.009
810,task_810,1014,1028,14,1014,1173,0.007
811,task_811,1153,1158,5,1152,1292,0.006
812,task_812,81,88,7,81,1075,0.007
813,task_813,759,764,5,759,999,0.01
814,task_814,341,354,13,341,905,0.013
815,task_815,540,546,6,540,785,0.011
816,task_816,1001,1011,10,1001,1251,0.014
817,task_817,298,309,11,298,751,0.012
818,task_818,1151,1158,7,1148,1402,0.008
819,task_819,12,20,8,12,152,0.01
820,task_820,1199,1208,9,1198,1378,0.01
821,task_821,1013,1019,6,1013,1153,0.008
822,task_822,745,757,12,745,903,0.005
823,task_823,760,774,14,760,896,0.009
824,task_824,1240,1247,7,845,1434,0.006
825,task_825,88,101,13,88,1186,0.008
826,task_826,1096,1101,5,1096,1176,0.006
827,task_827,566,577,11,566,847,0.014
828,task_828,301,306,5,301,477,0.012
829,task_829,379,384,5,379,642,0.011
830,task_830,371,381,10,357,1272,0.014
831,task_831,1156,1170,14,1155,1250,0.014
832,task_832,1064,1073,9,1062,1378,0.011
833,task_833,125,133,8,121,904,0.006
834,task_834,540,553,13,539,1212,0.012
835,task_835,387,397,10,355,1424,0.009
836,task_836,1112,1117,5,1111,1347,0.014
837,task_837,235,245,10,235,1004,0.005
838,task_838,1105,1118,13,1104,1287,0.012
839,task_839,1371,1381,10,1365,1431,0.006
840,task_840,739,749,10,738,1121,0.01
841,task_841,1222,1233,11,1222,1337,0.006
842,task_842,439,450,11,439,942,0.011
843,task_843,679,686,7,676,1369,0.012
844,task_844,1251,1260,9,1251,1361,0.007
845,task_845,1175,1188,13,1173,1371,0.009
846,task_846,1318,1329,11,1317,1417,0.008
847,task_847,1278,1288,10,1278,1370,0.007
848,task_848,291,304,13,291,1052,0.012
849,task_849,454,466,12,454,888,0.008
850,task_850,1339,1347,8,1339,1416,0.014
851,task_851,991,999,8,991,1018,0.013
852,task_852,388,398,10,388,1145,0.008
853,task_853,66,78,12,66,479,0.008
854,task_854,881,890,9,881,957,0.01
855,task_855,767,776,9,765,1371,0.008
856,task_856,159,170,11,159,561,0.005
857,task_857,1389,1399,10,1389,1417,0.012
858,task_858,1149,1154,5,1149,1367,0.01
859,task_859,1269,1283,14,1269,1360,0.01
860,task_860,106,118,12,106,1034,0.008
861,task_861,824,835,11,820,1236,0.008
862,task_862,692,700,8,687,1343,0.006
863,task_863,367,379,12,367,905,0.008
864,task_864,823,833,10,821,1029,0.007
865,task_865,1195,1208,13,1194,1362,0.01
866,task_866,153,160,7,153,385,0.006
867,task_867,915,925,10,915,1184,0.006
868,task_868,942,947,5,942,1208,0.005
869,task_869,244,249,5,244,264,0.014
870,task_870,48,58,10,48,380,0.01
871,task_871,1357,1363,6,698,1437,0.01
872,task_872,997,1011,14,996,1353,0.014
873,task_873,1106,1114,8,1106,1346,0.013
874,task_874,946,951,5,946,1107,0.014
875,task_875,747,757,10,747,918,0.01
876,task_876,604,616,12,604,839,0.005
877,task_877,987,997,10,867,1423,0.007
878,task_878,224,235,11,224,992,0.013
879,task_879,1231,1240,9,1231,1290,0.006
880,task_880,1208,1222,14,1187,1428,0.011
881,task_881,860,867,7,860,1342,0.013
882,task_882,776,783,7,776,873,0.012
883,task_883,121,126,5,121,543,0.01
884,task_884,567,573,6,567,845,0.006
885,task_885,750,759,9,750,907,0.014
886,task_886,1204,1211,7,1204,1312,0.011
887,task_887,731,740,9,731,1285,0.011
888,task_888,373,386,13,370,1361,0.007
889,task_889,1385,1398,13,1385,1412,0.013
890,task_890,812,818,6,812,962,0.009
891,task_891,131,144,13,131,887,0.009
892,task_892,543,549,6,543,611,0.005
893,task_893,131,138,7,131,967,0.007
894,task_894,1384,1390,6,1384,1437,0.007
895,task_895,1097,1111,14,1085,1401,0.009
896,task_896,1160,1165,5,1160,1222,0.011
897,task_897,1006,1015,9,1002,1399,0.007
898,task_898,462,476,14,462,1238,0.008
899,task_899,711,725,14,711,852,0.007
900,task_900,998,1004,6,998,1298,0.011
901,task_901,543,554,11,543,992,0.005
902,task_902,386,391,5,360,1417,0.01
903,task_903,753,763,10,745,1388,0.013
904,task_904,464,469,5,464,963,0.01
905,task_905,1252,1260,8,1252,1369,0.009
906,task_906,92,100,8,92,315,0.008
907,task_907,875,886,11,828,1392,0.007
908,task_908,590,604,14,590,938,0.009
909,task_909,59,69,10,59,289,0.005
910,task_910,199,213,14,199,267,0.007
911,task_911,800,813,13,800,969,0.005
912,task_912,163,169,6,163,1131,0.008
913,task_913,985,992,7,794,1415,0.013
914,task_914,55,69,14,55,841,0.01
915,task_915,783,792,9,783,822,0.006
916,task_916,1284,1292,8,1284,1340,0.009
917,task_917,189,198,9,189,907,0.011
918,task_918,204,210,6,202,1060,0.005
919,task_919,556,564,8,556,586,0.012
920,task_920,781,791,10,781,1005,0.007
921,task_921,802,809,7,794,1180,0.014
922,task_922,63,77,14,61,851,0.008
923,task_923,149,154,5,149,989,0.005
924,task_924,1188,1194,6,1185,1291,0.012
925,task_925,479,486,7,479,792,0.014
926,task_926,1157,1170,13,1156,1341,0.007
927,task_927,8,20,12,8,60,0.005
928,task_928,1377,1383,6,1376,1420,0.014
929,task_929,1335,1346,11,1335,1367,0.008
930,task_930,713,725,12,713,1278,0.012
931,task_931,223,234,11,223,268,0.012
932,task_932,493,501,8,493,745,0.006
933,task_933,615,623,8,612,1244,0.011
934,task_934,250,261,11,250,1041,0.012
935,task_935,1238,1250,12,1238,1289,0.011
936,task_936,60,72,12,60,706,0.008
937,task_937,167,175,8,165,750,0.009
938,task_938,636,645,9,636,1164,0.011
939,task_939,775,780,5,492,1432,0.013
940,task_940,423,428,5,423,968,0.014
941,task_941,779,790,11,779,1212,0.011
942,task_942,373,383,10,373,677,0.014
943,task_943,1097,1106,9,1097,1342,0.011
944,task_944,394,406,12,394,1027,0.013
945,task_945,951,959,8,950,1299,0.011
946,task_946,723,731,8,723,865,0.009
947,task_947,1361,1373,12,1361,1424,0.008
948,task_948,1235,1242,7,1235,1277,0.006
949,task_949,331,343,12,331,1192,0.012
950,task_950,329,342,13,329,1365,0.009
951,task_951,871,882,11,871,1014,0.012
952,task_952,734,743,9,734,1018,0.01
953,task_953,673,680,7,672,813,0.006
954,task_954,615,625,10,614,1159,0.007
955,task_955,6,18,12,6,428,0.005
956,task_956,140,145,5,140,647,0.01
957,task_957,1136,1147,11,1132,1409,0.005
958,task_958,376,387,11,374,1078,0.011
959,task_959,882,891,9,882,995,0.012
960,task_960,959,965,6,959,1147,0.01
961,task_961,1086,1095,9,1086,1249,0.009
962,task_962,98,106,8,98,361,0.005
963,task_963,34,47,13,34,791,0.01
964,task_964,366,372,6,366,723,0.014
965,task_965,304,312,8,304,924,0.013
966,task_966,515,523,8,515,1130,0.007
967,task_967,1320,1328,8,1320,1364,0.011
968,task_968,184,198,14,184,392,0.006
969,task_969,1334,1339,5,1334,1388,0.009
970,task_970,987,994,7,877,1418,0.005
971,task_971,137,148,11,137,273,0.006
972,task_972,337,342,5,337,680,0.007
973,task_973,1125,1137,12,1125,1201,0.011
974,task_974,900,907,7,896,1234,0.014
975,task_975,664,676,12,664,703,0.008
976,task_976,100,107,7,100,1261,0.005
977,task_977,39,48,9,39,1060,0.007
978,task_978,1007,1021,14,1007,1093,0.014
979,task_979,789,803,14,788,911,0.013
980,task_980,1223,1232,9,1223,1273,0.005
981,task_981,582,588,6,581,1109,0.011
982,task_982,632,638,6,632,1114,0.005
983,task_983,818,823,5,818,1222,0.009
984,task_984,1017,1029,12,1017,1391,0.005
985,task_985,506,515,9,506,548,0.008
986,task_986,460,469,9,460,1056,0.006
987,task_987,987,997,10,872,1423,0.009
988,task_988,734,743,9,734,929,0.012
989,task_989,175,182,7,175,408,0.007
990,task_990,1217,1228,11,1217,1325,0.009
991,task_991,1216,1226,10,1216,1299,0.013
992,task_992,854,862,8,852,1143,0.01
993,task_993,245,255,10,245,348,0.005
994,task_994,325,332,7,325,737,0.006
995,task_995,1279,1292,13,1274,1417,0.006
996,task_996,680,690,10,680,795,0.007
997,task_997,1074,1081,7,1074,1388,0.012
998,task_998,999,1011,12,999,1183,0.006
999,task_999,990,998,8,990,1092,0.011
1000,task_1000,1367,1372,5,1365,1417,0.008
1001,task_1001,16,24,8,16,321,0.005
1002,task_1002,139,146,7,139,667,0.006
1003,task_1003,817,822,5,804,1350,0.009
1004,task_1004,803,813,10,802,1205,0.007
1005,task_1005,316,328,12,316,1161,0.01
1006,task_1006,988,1002,14,988,1162,0.006
1007,task_1007,638,645,7,638,792,0.007
1008,task_1008,620,628,8,620,669,0.009
1009,task_1009,734,744,10,734,892,0.01
1010,task_1010,504,517,13,504,830,0.007
1011,task_1011,926,940,14,926,1030,0.014
1012,task_1012,43,51,8,43,600,0.008
1013,task_1013,541,553,12,499,1379,0.005
1014,task_1014,1059,1069,10,1059,1150,0.01
1015,task_1015,1207,1220,13,1198,1416,0.014
1016,task_1016,1366,1377,11,1366,1397,0.011
1017,task_1017,518,527,9,483,1291,0.009
1018,task_1018,81,87,6,81,329,0.013
1019,task_1019,758,771,13,684,1431,0.01
1020,task_1020,1033,1043,10,1032,1081,0.006
1021,task_1021,1074,1081,7,1074,1352,0.006
1022,task_1022,550,556,6,549,1003,0.013
1023,task_1023,312,325,13,310,1173,0.009
1024,task_1024,17,30,13,17,363,0.006
1025,task_1025,955,963,8,955,1209,0.014
1026,task_1026,1124,1138,14,1124,1367,0.012
1027,task_1027,911,924,13,911,1074,0.01
1028,task_1028,623,637,14,614,1375,0.011
1029,task_1029,237,250,13,237,363,0.014
1030,task_1030,1112,1124,12,1107,1349,0.005
1031,task_1031,251,260,9,251,1033,0.005
1032,task_1032,840,849,9,831,1334,0.01
1033,task_1033,1073,1086,13,1073,1155,0.012
1034,task_1034,1012,1021,9,1012,1160,0.011
1035,task_1035,255,264,9,255,1032,0.014
1036,task_1036,1382,1396,14,1382,1437,0.007
1037,task_1037,104,116,12,104,340,0.008
1038,task_1038,878,891,13,878,1095,0.009
1039,task_1039,167,181,14,166,670,0.01
1040,task_1040,830,837,7,830,1098,0.014
1041,task_1041,135,142,7,135,724,0.006
1042,task_1042,1147,1155,8,1145,1317,0.012
1043,task_1043,1356,1361,5,1355,1407,0.01
1044,task_1044,1397,1406,9,1397,1428,0.009
1045,task_1045,733,743,10,733,1155,0.012
1046,task_1046,1219,1229,10,1205,1433,0.012
1047,task_1047,221,232,11,220,1101,0.007
1048,task_1048,1192,1197,5,1192,1263,0.005
1049,task_1049,943,952,9,943,1235,0.011
1050,task_1050,1177,1188,11,1176,1406,0.01
1051,task_1051,1345,1351,6,1345,1376,0.005
1052,task_1052,100,106,6,100,982,0.006
1053,task_1053,347,352,5,347,732,0.007
1054,task_1054,521,527,6,521,541,0.008
1055,task_1055,913,926,13,913,1252,0.009
1056,task_1056,913,920,7,913,1045,0.014
1057,task_1057,1211,1218,7,1211,1376,0.009
1058,task_1058,41,52,11,41,1357,0.009
1059,task_1059,118,126,8,117,673,0.007
1060,task_1060,838,850,12,834,1246,0.006
1061,task_1061,1302,1309,7,1302,1420,0.013
1062,task_1062,130,142,12,129,444,0.014
1063,task_1063,645,657,12,645,799,0.012
1064,task_1064,1188,1200,12,1187,1320,0.011
1065,task_1065,865,876,11,864,1072,0.005
1066,task_1066,695,705,10,695,869,0.014
1067,task_1067,202,207,5,202,311,0.013
1068,task_1068,1006,1016,10,1004,1381,0.01
1069,task_1069,1237,1243,6,1237,1258,0.014
1070,task_1070,1016,1029,13,1016,1267,0.014
1071,task_1071,1080,1091,11,1080,1140,0.007
1072,task_1072,1357,1364,7,1342,1436,0.013
1073,task_1073,32,39,7,32,1201,0.005
1074,task_1074,700,711,11,698,1307,0.009
1075,task_1075,1292,1301,9,1291,1402,0.01
1076,task_1076,276,284,8,276,951,0.005
1077,task_1077,1351,1357,6,1351,1390,0.014
1078,task_1078,1219,1227,8,1006,1430,0.006
1079,task_1079,1266,1279,13,1265,1379,0.005
1080,task_1080,850,863,13,779,1373,0.012
1081,task_1081,1026,1035,9,1024,1264,0.006
1082,task_1082,709,718,9,709,971,0.011
1083,task_1083,342,348,6,342,1177,0.011
1084,task_1084,1010,1017,7,1010,1100,0.014
1085,task_1085,663,675,12,660,969,0.013
1086,task_1086,115,120,5,115,975,0.007
1087,task_1087,251,258,7,251,1356,0.011
1088,task_1088,346,357,11,346,582,0.008
1089,task_1089,442,448,6,442,873,0.013
1090,task_1090,1077,1089,12,1077,1164,0.012
1091,task_1091,794,805,11,793,985,0.014
1092,task_1092,282,293,11,282,468,0.009
1093,task_1093,754,764,10,754,1185,0.011
1094,task_1094,889,900,11,889,1051,0.009
1095,task_1095,1295,1301,6,1284,1414,0.011
1096,task_1096,925,932,7,925,1026,0.011
1097,task_1097,819,824,5,818,1332,0.009
1098,task_1098,899,908,9,896,1210,0.009
1099,task_1099,1073,1085,12,1071,1393,0.006
1100,task_1100,190,204,14,190,1401,0.011
1101,task_1101,880,887,7,879,1011,0.012
1102,task_1102,487,493,6,481,1202,0.013
1103,task_1103,589,603,14,589,694,0.011
1104,task_1104,139,146,7,118,1432,0.011
1105,task_1105,147,161,14,147,616,0.008
1106,task_1106,321,327,6,321,604,0.008
1107,task_1107,221,228,7,221,937,0.011
1108,task_1108,1128,1136,8,1126,1282,0.014
1109,task_1109,61,72,11,61,402,0.008
1110,task_1110,727,739,12,727,811,0.012
1111,task_1111,819,826,7,819,1232,0.011
1112,task_1112,479,492,13,479,1180,0.008
1113,task_1113,692,706,14,690,1144,0.006
1114,task_1114,325,338,13,325,1133,0.005
1115,task_1115,201,210,9,201,803,0.007
1116,task_1116,1255,1267,12,1254,1436,0.013
1117,task_1117,386,393,7,361,1417,0.007
1118,task_1118,490,502,12,488,989,0.01
1119,task_1119,1146,1152,6,1146,1249,0.012
1120,task_1120,70,76,6,70,198,0.005
1121,task_1121,601,615,14,519,1427,0.012
1122,task_1122,698,707,9,697,1047,0.011
1123,task_1123,697,709,12,696,971,0.009
1124,task_1124,514,527,13,512,1221,0.013
1125,task_1125,20,34,14,20,113,0.011
1126,task_1126,257,267,10,257,946,0.008
1127,task_1127,248,258,10,248,471,0.007
1128,task_1128,793,806,13,793,889,0.01
1129,task_1129,62,68,6,62,456,0.008
1130,task_1130,894,906,12,893,1230,0.01
1131,task_1131,1226,1237,11,1226,1287,0.006
1132,task_1132,19,32,13,19,674,0.007
1133,task_1133,1196,1205,9,1196,1284,0.005
1134,task_1134,172,179,7,172,972,0.011
1135,task_1135,397,408,11,396,1169,0.009
1136,task_1136,612,621,9,611,974,0.014
1137,task_1137,897,906,9,897,1116,0.005
1138,task_1138,684,692,8,684,1340,0.011
1139,task_1139,1189,1194,5,1189,1243,0.013
1140,task_1140,13,27,14,13,192,0.011
1141,task_1141,700,706,6,700,745,0.012
1142,task_1142,936,945,9,936,1001,0.005
1143,task_1143,1125,1138,13,1125,1196,0.01
1144,task_1144,1064,1076,12,1059,1385,0.005
1145,task_1145,62,73,11,61,416,0.011
1146,task_1146,280,288,8,280,470,0.008
1147,task_1147,660,671,11,660,716,0.007
1148,task_1148,915,920,5,915,946,0.014
1149,task_1149,1394,1404,10,1394,1426,0.012
1150,task_1150,1062,1076,14,1062,1093,0.006
1151,task_1151,514,521,7,514,1007,0.006
1152,task_1152,1078,1088,10,1078,1102,0.012
1153,task_1153,1229,1237,8,1229,1297,0.005
1154,task_1154,372,378,6,356,1324,0.01
1155,task_1155,979,986,7,979,1385,0.006
1156,task_1156,381,394,13,381,845,0.012
1157,task_1157,510,516,6,510,649,0.014
1158,task_1158,393,401,8,389,1344,0.012
1159,task_1159,310,317,7,310,467,0.013
1160,task_1160,317,322,5,317,1373,0.005
1161,task_1161,1030,1044,14,1027,1325,0.014
1162,task_1162,573,586,13,573,675,0.01
1163,task_1163,1192,1199,7,1192,1223,0.005
1164,task_1164,763,774,11,763,834,0.009
1165,task_1165,1330,1343,13,1267,1438,0.012
1166,task_1166,838,849,11,830,1229,0.005
1167,task_1167,1385,1396,11,1385,1412,0.006
1168,task_1168,1367,1375,8,1365,1408,0.006
1169,task_1169,515,523,8,488,1284,0.013
1170,task_1170,586,591,5,585,1303,0.014
1171,task_1171,1068,1080,12,1047,1415,0.012
1172,task_1172,722,736,14,722,1295,0.01
1173,task_1173,1274,1279,5,1274,1301,0.008
1174,task_1174,1384,1393,9,1384,1408,0.005
1175,task_1175,215,226,11,215,548,0.01
1176,task_1176,1039,1044,5,1039,1156,0.01
1177,task_1177,1070,1078,8,1070,1259,0.01
1178,task_1178,221,228,7,221,387,0.008
1179,task_1179,891,900,9,879,1350,0.006
1180,task_1180,334,346,12,334,510,0.014
1181,task_1181,1209,1221,12,1187,1430,0.005
1182,task_1182,478,490,12,478,614,0.014
1183,task_1183,763,776,13,763,965,0.009
1184,task_1184,1172,1185,13,1172,1286,0.014
1185,task_1185,1004,1016,12,1004,1082,0.007
1186,task_1186,7,16,9,7,838,0.009
1187,task_1187,776,786,10,776,991,0.009
1188,task_1188,1268,1276,8,1268,1362,0.007
1189,task_1189,676,687,11,676,1042,0.007
1190,task_1190,934,941,7,934,1104,0.007
1191,task_1191,4,13,9,4,259,0.011
1192,task_1192,1026,1035,9,1024,1258,0.009
1193,task_1193,976,983,7,976,1115,0.011
1194,task_1194,813,823,10,796,1316,0.008
1195,task_1195,348,356,8,348,950,0.006
1196,task_1196,416,428,12,414,1288,0.014
1197,task_1197,1030,1035,5,1024,1308,0.012
1198,task_1198,126,133,7,122,1285,0.011
1199,task_1199,960,973,13,933,1397,0.011
1200,task_1200,1329,1341,12,1314,1436,0.01
1201,task_1201,187,201,14,187,814,0.005
1202,task_1202,1003,1015,12,1003,1249,0.006
1203,task_1203,185,193,8,185,1207,0.013
1204,task_1204,927,938,11,927,1082,0.012
1205,task_1205,518,524,6,518,1246,0.005
1206,task_1206,1286,1293,7,1283,1352,0.014
1207,task_1207,571,579,8,570,1105,0.006
1208,task_1208,1223,1237,14,1223,1275,0.006
1209,task_1209,1107,1116,9,1107,1203,0.009
1210,task_1210,298,307,9,298,901,0.012
1211,task_1211,742,756,14,740,1296,0.013
1212,task_1212,56,69,13,56,1369,0.006
1213,task_1213,1232,1239,7,1232,1397,0.014
1214,task_1214,621,634,13,617,1340,0.011
1215,task_1215,1199,1207,8,1196,1377,0.014
1216,task_1216,116,122,6,108,1297,0.01
1217,task_1217,1181,1187,6,1181,1373,0.008
1218,task_1218,873,882,9,873,1330,0.008
1219,task_1219,517,522,5,517,608,0.006
1220,task_1220,463,473,10,463,1101,0.012
1221,task_1221,589,601,12,589,1069,0.007
1222,task_1222,1083,1091,8,1082,1264,0.011
1223,task_1223,1320,1332,12,1320,1420,0.01
1224,task_1224,1068,1074,6,1068,1268,0.008
1225,task_1225,258,272,14,258,1009,0.01
1226,task_1226,686,692,6,670,1420,0.007
1227,task_1227,837,851,14,834,1206,0.005
1228,task_1228,489,495,6,488,761,0.013
1229,task_1229,959,969,10,956,1376,0.006
1230,task_1230,856,862,6,856,1144,0.014
1231,task_1231,992,1006,14,992,1316,0.011
1232,task_1232,956,968,12,956,1353,0.006
1233,task_1233,183,188,5,183,1077,0.007
1234,task_1234,613,624,11,613,1034,0.009
1235,task_1235,1092,1099,7,1092,1157,0.01
1236,task_1236,887,892,5,883,1300,0.012
1237,task_1237,78,83,5,78,962,0.009
1238,task_1238,752,766,14,752,993,0.006
1239,task_1239,1337,1343,6,1337,1392,0.006
1240,task_1240,1101,1106,5,1101,1161,0.008
1241,task_1241,1134,1143,9,1134,1225,0.008
1242,task_1242,1164,1178,14,1164,1291,0.008
1243,task_1243,750,760,10,750,1081,0.007
1244,task_1244,1249,1255,6,1249,1382,0.009
1245,task_1245,842,847,5,842,893,0.011
1246,task_1246,678,686,8,678,823,0.008
1247,task_1247,540,552,12,539,907,0.013
1248,task_1248,855,860,5,853,1237,0.011
1249,task_1249,559,570,11,559,1038,0.013
1250,task_1250,393,406,13,393,1422,0.006
1251,task_1251,142,155,13,142,303,0.007
1252,task_1252,136,149,13,135,777,0.013
1253,task_1253,291,298,7,291,757,0.007
1254,task_1254,136,143,7,136,925,0.005
1255,task_1255,448,460,12,448,737,0.011
1256,task_1256,128,141,13,128,1076,0.007
1257,task_1257,37,42,5,37,1324,0.012
1258,task_1258,975,985,10,975,1197,0.005
1259,task_1259,601,610,9,601,1253,0.011
1260,task_1260,1279,1290,11,1279,1408,0.01
1261,task_1261,946,955,9,946,1314,0.006
1262,task_1262,1139,1152,13,1090,1427,0.012
1263,task_1263,546,559,13,546,626,0.014
1264,task_1264,789,801,12,789,814,0.007
1265,task_1265,1149,1158,9,1149,1355,0.006
1266,task_1266,302,310,8,302,896,0.005
1267,task_1267,377,384,7,377,1123,0.014
1268,task_1268,1278,1292,14,1278,1417,0.014
1269,task_1269,829,837,8,829,1026,0.007
1270,task_1270,1050,1059,9,1049,1187,0.011
1271,task_1271,1137,1151,14,1137,1288,0.013
1272,task_1272,1111,1122,11,1111,1247,0.007
1273,task_1273,75,86,11,75,270,0.013
1274,task_1274,1014,1023,9,1014,1335,0.011
1275,task_1275,1179,1192,13,1169,1416,0.007
1276,task_1276,895,907,12,895,1110,0.005
1277,task_1277,41,51,10,41,895,0.007
1278,task_1278,951,964,13,949,1273,0.008
1279,task_1279,330,342,12,330,1006,0.012
1280,task_1280,968,973,5,966,1286,0.011
1281,task_1281,200,210,10,199,1019,0.013
1282,task_1282,248,260,12,248,469,0.01
1283,task_1283,265,276,11,265,1054,0.006
1284,task_1284,264,274,10,264,544,0.011
1285,task_1285,98,111,13,98,1097,0.012
1286,task_1286,125,133,8,125,754,0.01
1287,task_1287,324,331,7,324,1128,0.005
1288,task_1288,134,148,14,134,1175,0.009
1289,task_1289,328,337,9,328,1432,0.005
1290,task_1290,718,727,9,718,1187,0.014
1291,task_1291,597,606,9,596,1219,0.006
1292,task_1292,422,435,13,422,1010,0.011
1293,task_1293,914,924,10,910,1385,0.007
1294,task_1294,1216,1223,7,1216,1288,0.008
1295,task_1295,631,641,10,631,1265,0.011
1296,task_1296,492,506,14,486,1220,0.012
1297,task_1297,708,717,9,703,1220,0.008
1298,task_1298,974,983,9,970,1393,0.009
1299,task_1299,272,284,12,272,1356,0.013
1300,task_1300,237,247,10,237,532,0.008
1301,task_1301,890,898,8,890,1071,0.012
1302,task_1302,1019,1032,13,1019,1230,0.013
1303,task_1303,200,214,14,200,1007,0.009
1304,task_1304,305,317,12,305,568,0.005
1305,task_1305,262,268,6,262,627,0.012
1306,task_1306,385,396,11,383,1197,0.008
1307,task_1307,1176,1183,7,1176,1315,0.006
1308,task_1308,1368,1379,11,1364,1424,0.009
1309,task_1309,1088,1099,11,1088,1376,0.007
1310,task_1310,161,175,14,161,532,0.011
1311,task_1311,237,251,14,237,1089,0.013
1312,task_1312,1187,1193,6,1186,1285,0.011
1313,task_1313,1294,1301,7,1294,1349,0.006
1314,task_1314,300,306,6,300,538,0.012
1315,task_1315,181,188,7,181,540,0.007
1316,task_1316,212,217,5,212,972,0.011
1317,task_1317,956,967,11,956,1273,0.011
1318,task_1318,844,858,14,842,1165,0.013
1319,task_1319,606,616,10,606,1015,0.011
1320,task_1320,823,836,13,820,1112,0.009
1321,task_1321,1362,1372,10,1362,1384,0.007
1322,task_1322,348,356,8,348,429,0.012
1323,task_1323,512,517,5,511,782,0.009
1324,task_1324,155,166,11,155,595,0.008
1325,task_1325,955,963,8,955,1252,0.005
1326,task_1326,60,66,6,60,349,0.006
1327,task_1327,916,926,10,891,1393,0.012
1328,task_1328,644,655,11,643,1390,0.008
1329,task_1329,959,967,8,958,1262,0.011
1330,task_1330,1380,1389,9,1380,1400,0.011
1331,task_1331,80,93,13,80,396,0.01
1332,task_1332,262,272,10,262,708,0.012
1333,task_1333,1085,1090,5,1085,1274,0.006
1334,task_1334,854,865,11,853,1118,0.013
1335,task_1335,1338,1347,9,1336,1416,0.012
1336,task_1336,925,935,10,925,1301,0.006
1337,task_1337,186,195,9,186,516,0.011
1338,task_1338,1202,1214,12,1202,1304,0.007
1339,task_1339,302,308,6,302,937,0.013
1340,task_1340,1179,1190,11,1169,1412,0.005
1341,task_1341,475,487,12,475,1423,0.009
1342,task_1342,387,393,6,387,1317,0.013
1343,task_1343,950,959,9,950,1098,0.006
1344,task_1344,926,937,11,926,1018,0.009
1345,task_1345,669,681,12,667,1308,0.009
1346,task_1346,1364,1369,5,1364,1388,0.012
1347,task_1347,1196,1206,10,1196,1295,0.005
1348,task_1348,89,101,12,89,971,0.011
1349,task_1349,710,720,10,710,763,0.005
1350,task_1350,1038,1051,13,1038,1212,0.014
1351,task_1351,713,724,11,712,933,0.01
1352,task_1352,1172,1180,8,1172,1251,0.006
1353,task_1353,593,602,9,562,1409,0.012
1354,task_1354,784,797,13,784,861,0.008
1355,task_1355,652,665,13,651,974,0.011
1356,task_1356,945,957,12,945,1064,0.01
1357,task_1357,797,807,10,797,1059,0.014
1358,task_1358,1013,1027,14,1013,1212,0.005
1359,task_1359,431,444,13,431,772,0.011
1360,task_1360,319,332,13,319,1101,0.005
1361,task_1361,1158,1172,14,1155,1389,0.005
1362,task_1362,223,234,11,223,535,0.009
1363,task_1363,616,621,5,616,1141,0.01
1364,task_1364,280,290,10,280,943,0.006
1365,task_1365,1281,1287,6,1281,1334,0.009
1366,task_1366,104,114,10,104,347,0.005
1367,task_1367,1360,1366,6,1359,1412,0.005
1368,task_1368,127,137,10,127,1252,0.014
1369,task_1369,99,110,11,99,747,0.007
1370,task_1370,544,554,10,544,747,0.012
1371,task_1371,790,801,11,789,979,0.007
1372,task_1372,57,64,7,57,232,0.012
1373,task_1373,756,766,10,754,1329,0.013
1374,task_1374,681,688,7,680,887,0.01
1375,task_1375,1195,1200,5,1195,1317,0.007
1376,task_1376,1384,1393,9,1383,1436,0.013
1377,task_1377,268,281,13,268,948,0.014
1378,task_1378,725,737,12,717,1368,0.007
1379,task_1379,644,649,5,644,1221,0.011
1380,task_1380,1187,1193,6,1187,1278,0.009
1381,task_1381,293,302,9,293,603,0.011
1382,task_1382,15,24,9,12,1157,0.01
1383,task_1383,10,17,7,10,152,0.014
1384,task_1384,905,912,7,905,1203,0.006
1385,task_1385,630,643,13,630,1198,0.006
1386,task_1386,769,780,11,692,1432,0.014
1387,task_1387,629,635,6,629,884,0.011
1388,task_1388,1222,1227,5,1222,1237,0.01
1389,task_1389,898,909,11,898,1067,0.013
1390,task_1390,994,1007,13,994,1128,0.007
1391,task_1391,357,366,9,357,985,0.009
1392,task_1392,912,922,10,912,1063,0.008
1393,task_1393,981,987,6,977,1386,0.011
1394,task_1394,188,198,10,188,966,0.005
1395,task_1395,337,349,12,337,1134,0.014
1396,task_1396,545,554,9,545,627,0.007
1397,task_1397,159,170,11,159,564,0.012
1398,task_1398,1151,1161,10,1151,1300,0.011
1399,task_1399,137,148,11,137,978,0.009
1400,task_1400,554,568,14,546,1279,0.01
1401,task_1401,902,910,8,902,984,0.009
1402,task_1402,486,493,7,486,1116,0.009
1403,task_1403,53,58,5,53,377,0.011
1404,task_1404,183,197,14,183,1076,0.009
1405,task_1405,1123,1130,7,1123,1146,0.013
1406,task_1406,262,271,9,262,595,0.007
1407,task_1407,382,393,11,382,751,0.008
1408,task_1408,1368,1381,13,1368,1394,0.014
1409,task_1409,219,231,12,219,993,0.006
1410,task_1410,875,880,5,875,1218,0.009
1411,task_1411,148,154,6,143,1282,0.009
1412,task_1412,1043,1055,12,1040,1296,0.012
1413,task_1413,28,38,10,28,728,0.01
1414,task_1414,523,532,9,523,907,0.009
1415,task_1415,1055,1065,10,1042,1389,0.012
1416,task_1416,3,9,6,3,206,0.012
1417,task_1417,990,1003,13,990,1057,0.008
1418,task_1418,181,194,13,181,687,0.012
1419,task_1419,1330,1344,14,1327,1438,0.009
1420,task_1420,1050,1060,10,1049,1177,0.012
1421,task_1421,1127,1140,13,1127,1236,0.013
1422,task_1422,355,362,7,355,733,0.008
1423,task_1423,1270,1284,14,1270,1354,0.011
1424,task_1424,751,765,14,751,1189,0.007
1425,task_1425,148,156,8,147,1178,0.008
1426,task_1426,145,156,11,145,334,0.014
1427,task_1427,1362,1367,5,671,1438,0.012
1428,task_1428,937,951,14,936,1131,0.013
1429,task_1429,984,991,7,984,1132,0.01
1430,task_1430,748,754,6,748,910,0.008
1431,task_1431,767,775,8,767,1205,0.009
1432,task_1432,387,393,6,387,1401,0.005
1433,task_1433,272,282,10,272,995,0.007
1434,task_1434,120,134,14,120,1110,0.012
1435,task_1435,812,817,5,812,1292,0.005
1436,task_1436,582,593,11,582,961,0.008
1437,task_1437,159,164,5,159,387,0.01
1438,task_1438,1217,1222,5,1216,1416,0.011
1439,task_1439,693,700,7,693,818,0.007
1440,task_1440,393,405,12,393,443,0.005
1441,task_1441,770,781,11,770,1076,0.007
1442,task_1442,355,362,7,355,516,0.012
1443,task_1443,436,445,9,436,1160,0.005
1444,task_1444,223,230,7,221,1211,0.006
1445,task_1445,1307,1315,8,1307,1392,0.011
1446,task_1446,862,873,11,860,1387,0.012
1447,task_1447,1380,1387,7,1378,1431,0.006
1448,task_1448,947,961,14,947,1135,0.009
1449,task_1449,778,783,5,778,1047,0.014
1450,task_1450,1325,1335,10,1322,1430,0.014
1451,task_1451,465,470,5,465,1209,0.006
1452,task_1452,1304,1312,8,1304,1325,0.011
1453,task_1453,1371,1379,8,1371,1399,0.007
1454,task_1454,1037,1042,5,1035,1353,0.01
1455,task_1455,853,867,14,853,882,0.012
1456,task_1456,691,702,11,691,885,0.006
1457,task_1457,348,359,11,348,1201,0.01
1458,task_1458,115,126,11,111,1202,0.006
1459,task_1459,546,560,14,546,1068,0.005
1460,task_1460,408,416,8,408,862,0.011
1461,task_1461,86,98,12,85,399,0.014
1462,task_1462,432,443,11,432,596,0.009
1463,task_1463,116,126,10,108,1304,0.006
1464,task_1464,803,813,10,793,1220,0.01
1465,task_1465,427,436,9,427,641,0.005
1466,task_1466,659,667,8,652,1291,0.008
1467,task_1467,345,351,6,345,1043,0.009
1468,task_1468,45,50,5,45,1016,0.012
1469,task_1469,241,254,13,241,1365,0.009
1470,task_1470,678,685,7,678,1058,0.009
1471,task_1471,1293,1300,7,1287,1407,0.008
1472,task_1472,1183,1197,14,1183,1220,0.011
1473,task_1473,762,767,5,760,1361,0.01
1474,task_1474,372,379,7,363,1277,0.01
1475,task_1475,687,693,6,687,1224,0.007
1476,task_1476,904,917,13,904,1166,0.007
1477,task_1477,606,613,7,606,1128,0.013
1478,task_1478,411,417,6,411,1031,0.013
1479,task_1479,1349,1361,12,1349,1423,0.005
1480,task_1480,912,922,10,911,1173,0.006
1481,task_1481,1267,1278,11,1266,1386,0.008
1482,task_1482,1253,1263,10,1253,1389,0.008
1483,task_1483,1084,1097,13,1084,1143,0.007
1484,task_1484,177,189,12,177,1069,0.01
1485,task_1485,607,621,14,607,784,0.008
1486,task_1486,1150,1164,14,1150,1253,0.01
1487,task_1487,620,629,9,619,931,0.013
1488,task_1488,1078,1086,8,1078,1112,0.01
1489,task_1489,725,732,7,725,1180,0.008
1490,task_1490,522,536,14,521,1132,0.011
1491,task_1491,151,156,5,151,576,0.011
1492,task_1492,1270,1280,10,1270,1307,0.01
1493,task_1493,1382,1387,5,1382,1402,0.005
1494,task_1494,1141,1151,10,1141,1174,0.007
1495,task_1495,257,265,8,257,507,0.008
1496,task_1496,922,931,9,918,1220,0.005
1497,task_1497,725,734,9,689,1365,0.008
1498,task_1498,1080,1085,5,1079,1331,0.009
1499,task_1499,108,122,14,108,618,0.014
1500,task_1500,396,404,8,396,919,0.01
1501,task_1501,505,518,13,503,1246,0.013
1502,task_1502,628,642,14,493,1437,0.013
1503,task_1503,225,236,11,225,912,0.007
1504,task_1504,189,197,8,189,1057,0.011
1505,task_1505,726,734,8,726,1102,0.009
1506,task_1506,1287,1292,5,1287,1308,0.007
1507,task_1507,183,190,7,183,663,0.012
1508,task_1508,227,237,10,225,1383,0.01
1509,task_1509,1238,1243,5,1235,1420,0.013
1510,task_1510,324,336,12,324,1235,0.009
1511,task_1511,474,488,14,474,956,0.01
1512,task_1512,288,294,6,288,1132,0.013
1513,task_1513,5,10,5,5,1023,0.011
1514,task_1514,222,230,8,222,360,0.007
1515,task_1515,1362,1375,13,1362,1389,0.007
1516,task_1516,219,228,9,219,387,0.006
1517,task_1517,954,962,8,954,1341,0.011
1518,task_1518,1136,1149,13,1134,1369,0.008
1519,task_1519,813,823,10,796,1312,0.006
1520,task_1520,748,758,10,748,879,0.011
1521,task_1521,1238,1244,6,1237,1359,0.005
1522,task_1522,1048,1054,6,1048,1330,0.014
1523,task_1523,1390,1401,11,1390,1436,0.008
1524,task_1524,1080,1089,9,1078,1217,0.009
1525,task_1525,172,182,10,172,276,0.012
1526,task_1526,265,279,14,265,671,0.007
1527,task_1527,1173,1187,14,1173,1333,0.013
1528,task_1528,10,20,10,10,1048,0.012
1529,task_1529,847,852,5,832,1347,0.008
1530,task_1530,84,97,13,83,882,0.013
1531,task_1531,822,827,5,822,922,0.011
1532,task_1532,859,865,6,858,1329,0.008
1533,task_1533,841,849,8,829,1345,0.01
1534,task_1534,1179,1188,9,1179,1213,0.007
1535,task_1535,1062,1076,14,1062,1333,0.005
1536,task_1536,14,24,10,14,916,0.009
1537,task_1537,556,562,6,556,1035,0.008
1538,task_1538,246,252,6,246,853,0.005
1539,task_1539,1035,1048,13,1035,1153,0.005
1540,task_1540,1271,1277,6,1271,1299,0.007
1541,task_1541,1332,1343,11,1331,1427,0.008
1542,task_1542,459,467,8,459,1185,0.008
1543,task_1543,1247,1253,6,1247,1397,0.005
1544,task_1544,1339,1345,6,1339,1393,0.005
1545,task_1545,294,301,7,293,1134,0.006
1546,task_1546,340,354,14,340,748,0.008
1547,task_1547,588,601,13,588,855,0.006
1548,task_1548,1281,1295,14,1280,1341,0.007
1549,task_1549,323,330,7,323,1246,0.008
1550,task_1550,362,372,10,358,1187,0.009
1551,task_1551,531,542,11,531,772,0.011
1552,task_1552,483,489,6,483,773,0.007
1553,task_1553,148,155,7,145,1248,0.01
1554,task_1554,153,164,11,152,567,0.006
1555,task_1555,1319,1330,11,1307,1425,0.009
1556,task_1556,618,631,13,606,1284,0.013
1557,task_1557,357,363,6,357,847,0.007
1558,task_1558,650,658,8,650,828,0.007
1559,task_1559,1321,1334,13,1321,1410,0.011
1560,task_1560,788,794,6,788,888,0.006
1561,task_1561,262,272,10,262,533,0.012
1562,task_1562,1400,1408,8,1398,1439,0.006
1563,task_1563,421,426,5,421,1429,0.01
1564,task_1564,922,931,9,920,1221,0.008
1565,task_1565,614,628,14,612,1151,0.012
1566,task_1566,1312,1320,8,1312,1350,0.014
1567,task_1567,149,155,6,149,289,0.013
1568,task_1568,1158,1165,7,1156,1343,0.01
1569,task_1569,178,184,6,178,1013,0.005
1570,task_1570,867,872,5,867,1193,0.014
1571,task_1571,263,276,13,263,1368,0.013
1572,task_1572,776,787,11,776,1057,0.009
1573,task_1573,1283,1290,7,1283,1332,0.014
1574,task_1574,1369,1377,8,1369,1413,0.008
1575,task_1575,1043,1055,12,1043,1238,0.013
1576,task_1576,840,854,14,828,1328,0.011
1577,task_1577,961,969,8,961,1192,0.006
1578,task_1578,1248,1258,10,1248,1291,0.012
1579,task_1579,622,631,9,620,1352,0.008
1580,task_1580,136,149,13,136,689,0.013
1581,task_1581,518,523,5,518,1131,0.007
1582,task_1582,1030,1041,11,1023,1343,0.007
1583,task_1583,56,66,10,56,400,0.009
1584,task_1584,336,341,5,336,760,0.011
1585,task_1585,736,749,13,736,1427,0.011
1586,task_1586,507,513,6,499,1249,0.012
1587,task_1587,770,784,14,770,856,0.009
1588,task_1588,1297,1307,10,1289,1419,0.008
1589,task_1589,774,786,12,774,996,0.013
1590,task_1590,478,485,7,478,1359,0.007
1591,task_1591,76,84,8,76,847,0.012
1592,task_1592,1362,1373,11,1362,1434,0.006
1593,task_1593,1344,1357,13,1344,1429,0.013
1594,task_1594,822,836,14,822,961,0.005
1595,task_1595,306,311,5,306,1183,0.008
1596,task_1596,416,424,8,415,1358,0.006
1597,task_1597,278,288,10,278,1323,0.008
1598,task_1598,79,89,10,79,1153,0.014
1599,task_1599,557,569,12,557,729,0.007
1600,task_1600,682,693,11,682,789,0.006
1601,task_1601,75,80,5,75,1005,0.011
1602,task_1602,906,912,6,901,1326,0.014
1603,task_1603,509,515,6,506,1272,0.012
1604,task_1604,661,673,12,661,714,0.011
1605,task_1605,1057,1064,7,1057,1105,0.009
1606,task_1606,730,739,9,730,792,0.006
1607,task_1607,169,179,10,169,879,0.007
1608,task_1608,297,311,14,297,942,0.008
1609,task_1609,895,902,7,884,1382,0.01
1610,task_1610,692,701,9,692,920,0.008
1611,task_1611,1278,1286,8,1273,1408,0.007
1612,task_1612,152,164,12,152,311,0.012
1613,task_1613,203,212,9,203,779,0.008
1614,task_1614,696,708,12,696,860,0.012
1615,task_1615,939,945,6,938,1320,0.012
1616,task_1616,410,416,6,410,488,0.012
1617,task_1617,153,159,6,153,504,0.012
1618,task_1618,1300,1313,13,1283,1424,0.013
1619,task_1619,476,483,7,476,653,0.006
1620,task_1620,970,979,9,969,1348,0.008
1621,task_1621,384,397,13,381,1180,0.012
1622,task_1622,532,541,9,532,1312,0.011
1623,task_1623,1288,1297,9,1288,1343,0.006
1624,task_1624,1377,1384,7,1377,1402,0.007
1625,task_1625,605,613,8,535,1430,0.012
1626,task_1626,121,128,7,121,605,0.013
1627,task_1627,86,98,12,86,468,0.013
1628,task_1628,1365,1375,10,1365,1388,0.01
1629,task_1629,1236,1248,12,1236,1302,0.007
1630,task_1630,1357,1363,6,1285,1435,0.008
1631,task_1631,194,201,7,194,682,0.011
1632,task_1632,731,738,7,720,1405,0.012
1633,task_1633,37,45,8,37,869,0.005
1634,task_1634,1159,1171,12,1159,1219,0.008
1635,task_1635,1367,1380,13,1366,1421,0.008
1636,task_1636,302,313,11,302,766,0.011
1637,task_1637,890,900,10,890,1212,0.011
1638,task_1638,490,496,6,483,1206,0.01
1639,task_1639,1030,1038,8,1023,1332,0.005
1640,task_1640,578,584,6,577,938,0.011
1641,task_1641,779,790,11,776,1186,0.008
1642,task_1642,1341,1353,12,1340,1405,0.012
1643,task_1643,629,638,9,629,1256,0.009
1644,task_1644,474,481,7,474,997,0.01
1645,task_1645,1045,1055,10,1045,1293,0.007
1646,task_1646,1363,1374,11,1363,1435,0.011
1647,task_1647,257,267,10,257,865,0.013
1648,task_1648,810,819,9,810,1064,0.008
1649,task_1649,1202,1212,10,1194,1408,0.01
1650,task_1650,877,885,8,877,931,0.012
1651,task_1651,1372,1382,10,1372,1421,0.014
1652,task_1652,1228,1238,10,796,1435,0.013
1653,task_1653,874,884,10,874,1382,0.007
1654,task_1654,1286,1300,14,1280,1364,0.014
1655,task_1655,1173,1181,8,1170,1329,0.009
1656,task_1656,827,834,7,825,1260,0.012
1657,task_1657,306,312,6,306,1157,0.005
1658,task_1658,1152,1165,13,1152,1221,0.014
1659,task_1659,375,388,13,374,807,0.007
1660,task_1660,73,86,13,73,600,0.006
1661,task_1661,1378,1391,13,1375,1434,0.008
1662,task_1662,416,424,8,416,733,0.012
1663,task_1663,215,229,14,215,330,0.005
1664,task_1664,1200,1207,7,1191,1399,0.008
1665,task_1665,1294,1305,11,1294,1373,0.006
1666,task_1666,105,110,5,102,837,0.008
1667,task_1667,1329,1337,8,1329,1411,0.006
1668,task_1668,727,734,7,727,1173,0.008
1669,task_1669,812,826,14,784,1303,0.01
1670,task_1670,1266,1273,7,1266,1346,0.007
1671,task_1671,342,353,11,342,441,0.013
1672,task_1672,1074,1081,7,1074,1226,0.011
1673,task_1673,252,265,13,252,403,0.005
1674,task_1674,1146,1158,12,1145,1307,0.013
1675,task_1675,1293,1305,12,1274,1416,0.009
1676,task_1676,1009,1021,12,1008,1262,0.006
1677,task_1677,867,879,12,867,936,0.006
1678,task_1678,924,938,14,924,1296,0.014
1679,task_1679,473,485,12,473,1438,0.005
1680,task_1680,1378,1384,6,1372,1426,0.011
1681,task_1681,1081,1087,6,1081,1221,0.013
1682,task_1682,1008,1020,12,1008,1105,0.013
1683,task_1683,388,401,13,388,1257,0.008
1684,task_1684,1364,1378,14,1364,1423,0.013
1685,task_1685,805,819,14,795,1239,0.014
1686,task_1686,417,422,5,417,688,0.01
1687,task_1687,222,236,14,222,701,0.006
1688,task_1688,361,372,11,358,1185,0.006
1689,task_1689,401,406,5,401,767,0.005
1690,task_1690,18,30,12,16,731,0.006
1691,task_1691,1111,1118,7,1111,1148,0.012
1692,task_1692,423,429,6,423,1192,0.005
1693,task_1693,278,284,6,278,1260,0.014
1694,task_1694,507,512,5,506,1210,0.013
1695,task_1695,572,578,6,572,1007,0.007
1696,task_1696,1300,1311,11,1300,1405,0.007
1697,task_1697,244,254,10,244,541,0.006
1698,task_1698,575,586,11,575,1033,0.011
1699,task_1699,456,468,12,456,1402,0.012
1700,task_1700,838,850,12,837,1212,0.011
1701,task_1701,805,814,9,805,1019,0.008
1702,task_1702,523,529,6,501,1305,0.011
1703,task_1703,64,72,8,60,1243,0.007
1704,task_1704,1393,1407,14,1392,1425,0.005
1705,task_1705,926,940,14,926,1186,0.008
1706,task_1706,676,690,14,674,1287,0.014
1707,task_1707,804,813,9,804,850,0.006
1708,task_1708,1331,1345,14,1331,1372,0.009
1709,task_1709,1274,1284,10,1274,1337,0.011
1710,task_1710,691,696,5,689,990,0.005
1711,task_1711,1117,1126,9,1116,1306,0.007
1712,task_1712,541,548,7,537,1329,0.011
1713,task_1713,414,422,8,414,1210,0.005
1714,task_1714,1149,1154,5,1147,1367,0.013
1715,task_1715,1005,1011,6,1005,1367,0.01
1716,task_1716,377,382,5,377,1342,0.006
1717,task_1717,512,518,6,510,963,0.007
1718,task_1718,287,300,13,287,1357,0.005
1719,task_1719,1031,1045,14,1031,1163,0.014
1720,task_1720,460,465,5,460,1219,0.009
1721,task_1721,1136,1145,9,1133,1360,0.006
1722,task_1722,707,715,8,707,1127,0.014
1723,task_1723,1031,1039,8,1025,1359,0.008
1724,task_1724,513,520,7,513,1063,0.014
1725,task_1725,496,502,6,496,525,0.01
1726,task_1726,880,892,12,880,906,0.01
1727,task_1727,300,312,12,300,807,0.012
1728,task_1728,729,736,7,729,1275,0.011
1729,task_1729,640,654,14,640,867,0.01
1730,task_1730,679,684,5,679,835,0.008
1731,task_1731,932,941,9,932,998,0.005
1732,task_1732,1050,1064,14,1049,1314,0.012
1733,task_1733,430,439,9,430,1270,0.006
1734,task_1734,34,46,12,34,973,0.007
1735,task_1735,763,775,12,763,1106,0.012
1736,task_1736,912,917,5,912,1023,0.006
1737,task_1737,1184,1194,10,1184,1266,0.007
1738,task_1738,326,332,6,326,1338,0.013
1739,task_1739,164,173,9,164,456,0.005
1740,task_1740,775,785,10,775,1426,0.009
1741,task_1741,1262,1271,9,1262,1344,0.005
1742,task_1742,1208,1222,14,1208,1378,0.005
1743,task_1743,23,32,9,23,640,0.007
1744,task_1744,1197,1206,9,1197,1358,0.012
1745,task_1745,1370,1382,12,1370,1419,0.011
1746,task_1746,722,733,11,722,1020,0.01
1747,task_1747,67,78,11,67,421,0.01
1748,task_1748,729,743,14,729,1399,0.009
1749,task_1749,348,358,10,348,640,0.009
1750,task_1750,1034,1048,14,1032,1091,0.011
1751,task_1751,835,847,12,835,1027,0.012
1752,task_1752,815,828,13,815,975,0.014
1753,task_1753,621,627,6,621,952,0.009
1754,task_1754,1001,1015,14,1001,1200,0.009
1755,task_1755,222,231,9,222,631,0.006
1756,task_1756,641,651,10,640,1205,0.012
1757,task_1757,1379,1387,8,1379,1405,0.01
1758,task_1758,480,487,7,480,1265,0.011
1759,task_1759,1106,1115,9,1106,1298,0.012
1760,task_1760,765,776,11,765,965,0.01
1761,task_1761,1320,1334,14,1320,1433,0.012
1762,task_1762,292,297,5,292,569,0.014
1763,task_1763,462,474,12,462,1030,0.008
1764,task_1764,1243,1255,12,1243,1432,0.01
1765,task_1765,916,927,11,916,1134,0.01
1766,task_1766,597,607,10,595,1373,0.011
1767,task_1767,1359,1368,9,1359,1381,0.01
1768,task_1768,653,664,11,649,1135,0.005
1769,task_1769,492,498,6,492,1241,0.012
1770,task_1770,1147,1159,12,1144,1317,0.01
1771,task_1771,959,970,11,957,1377,0.01
1772,task_1772,310,322,12,310,413,0.005
1773,task_1773,812,818,6,812,1192,0.009
1774,task_1774,789,801,12,789,886,0.006
1775,task_1775,823,832,9,823,908,0.011
1776,task_1776,173,182,9,173,264,0.011
1777,task_1777,125,136,11,124,862,0.012
1778,task_1778,194,208,14,194,1225,0.012
1779,task_1779,185,193,8,185,571,0.007
1780,task_1780,456,464,8,456,784,0.009
1781,task_1781,193,207,14,192,1000,0.007
1782,task_1782,1036,1050,14,1036,1289,0.008
1783,task_1783,824,833,9,823,1205,0.011
1784,task_1784,273,287,14,273,845,0.011
1785,task_1785,1156,1162,6,1156,1186,0.005
1786,task_1786,1287,1298,11,1285,1371,0.007
1787,task_1787,51,59,8,51,1326,0.009
1788,task_1788,634,643,9,629,1357,0.01
1789,task_1789,1260,1270,10,1258,1328,0.005
1790,task_1790,1036,1041,5,1036,1238,0.005
1791,task_1791,608,614,6,608,973,0.01
1792,task_1792,1107,1112,5,1107,1207,0.009
1793,task_1793,0,11,11,0,1370,0.009
1794,task_1794,451,460,9,451,669,0.014
1795,task_1795,1387,1398,11,1385,1432,0.012
1796,task_1796,563,570,7,560,1129,0.012
1797,task_1797,850,862,12,850,959,0.011
1798,task_1798,1246,1254,8,1246,1330,0.006
1799,task_1799,53,67,14,53,733,0.008
1800,task_1800,685,692,7,653,1375,0.009
1801,task_1801,30,38,8,30,419,0.007
1802,task_1802,1113,1123,10,1113,1331,0.011
1803,task_1803,357,364,7,353,1117,0.01
1804,task_1804,675,681,6,672,982,0.007
1805,task_1805,647,658,11,647,801,0.007
1806,task_1806,688,697,9,687,1293,0.006
1807,task_1807,676,690,14,676,990,0.008
1808,task_1808,1015,1027,12,1015,1075,0.008
1809,task_1809,107,119,12,107,833,0.013
1810,task_1810,920,933,13,918,1130,0.008
1811,task_1811,652,662,10,652,712,0.005
1812,task_1812,249,257,8,249,1362,0.005
1813,task_1813,652,661,9,651,1089,0.01
1814,task_1814,79,93,14,79,220,0.005
1815,task_1815,125,137,12,121,964,0.006
1816,task_1816,1172,1177,5,1172,1261,0.013
1817,task_1817,1072,1079,7,1072,1287,0.006
1818,task_1818,225,231,6,223,1246,0.013
1819,task_1819,529,539,10,529,1051,0.009
1820,task_1820,1114,1121,7,1108,1394,0.008
1821,task_1821,416,425,9,416,685,0.011
1822,task_1822,527,540,13,527,606,0.011
1823,task_1823,858,869,11,858,1075,0.012
1824,task_1824,478,492,14,478,1405,0.01
1825,task_1825,1390,1395,5,1390,1414,0.008
1826,task_1826,1293,1306,13,1291,1420,0.009
1827,task_1827,104,113,9,102,534,0.014
1828,task_1828,114,123,9,114,653,0.006
1829,task_1829,1276,1289,13,1276,1309,0.013
1830,task_1830,144,151,7,144,378,0.009
1831,task_1831,727,736,9,727,1329,0.012
1832,task_1832,1279,1290,11,1279,1360,0.011
1833,task_1833,655,662,7,655,856,0.008
1834,task_1834,967,981,14,966,1259,0.01
1835,task_1835,183,188,5,183,960,0.008
1836,task_1836,440,446,6,440,1166,0.01
1837,task_1837,1002,1008,6,1002,1188,0.005
1838,task_1838,628,637,9,569,1435,0.011
1839,task_1839,817,824,7,813,1349,0.011
1840,task_1840,846,859,13,842,1239,0.01
1841,task_1841,1145,1158,13,1145,1216,0.014
1842,task_1842,841,850,9,841,1003,0.014
1843,task_1843,45,54,9,45,738,0.005
1844,task_1844,1273,1287,14,1269,1407,0.01
1845,task_1845,751,764,13,745,1307,0.009
1846,task_1846,51,65,14,51,504,0.01
1847,task_1847,463,472,9,463,1006,0.013
1848,task_1848,217,228,11,210,1261,0.007
1849,task_1849,1328,1334,6,1328,1396,0.013
1850,task_1850,431,438,7,431,1239,0.005
1851,task_1851,869,874,5,869,1264,0.006
1852,task_1852,643,655,12,643,861,0.012
1853,task_1853,375,382,7,375,665,0.011
1854,task_1854,319,331,12,319,545,0.014
1855,task_1855,1184,1198,14,1184,1286,0.007
1856,task_1856,498,510,12,498,878,0.008
1857,task_1857,780,792,12,778,1257,0.012
1858,task_1858,859,868,9,835,1369,0.009
1859,task_1859,230,235,5,226,1416,0.013
1860,task_1860,880,887,7,879,1013,0.012
1861,task_1861,1201,1209,8,1201,1248,0.006
1862,task_1862,483,492,9,483,754,0.009
1863,task_1863,1022,1028,6,975,1422,0.011
1864,task_1864,705,713,8,705,904,0.012
1865,task_1865,1060,1068,8,1057,1339,0.014
1866,task_1866,455,466,11,455,1387,0.012
1867,task_1867,514,520,6,514,548,0.005
1868,task_1868,407,414,7,407,584,0.014
1869,task_1869,723,735,12,722,1356,0.005
1870,task_1870,258,272,14,258,413,0.01
1871,task_1871,991,999,8,991,1077,0.008
1872,task_1872,520,529,9,519,611,0.014
1873,task_1873,1316,1329,13,1316,1356,0.014
1874,task_1874,794,800,6,794,956,0.007
1875,task_1875,56,67,11,56,429,0.011
1876,task_1876,943,957,14,943,1078,0.011
1877,task_1877,758,765,7,750,1410,0.012
1878,task_1878,498,508,10,498,779,0.009
1879,task_1879,795,803,8,793,1021,0.006
1880,task_1880,644,656,12,644,1408,0.009
1881,task_1881,375,381,6,374,647,0.011
1882,task_1882,344,357,13,344,1417,0.008
1883,task_1883,912,923,11,903,1367,0.012
1884,task_1884,965,975,10,964,1390,0.009
1885,task_1885,204,209,5,202,1168,0.012
1886,task_1886,836,844,8,834,1115,0.008
1887,task_1887,55,65,10,55,504,0.01
1888,task_1888,77,88,11,77,593,0.007
1889,task_1889,397,405,8,397,448,0.014
1890,task_1890,814,821,7,809,1322,0.01
1891,task_1891,800,814,14,799,871,0.01
1892,task_1892,971,979,8,971,1267,0.011
1893,task_1893,1064,1076,12,1060,1391,0.008
1894,task_1894,1033,1045,12,1033,1067,0.008
1895,task_1895,269,276,7,269,680,0.006
1896,task_1896,1343,1357,14,1343,1415,0.01
1897,task_1897,1068,1075,7,1060,1409,0.011
1898,task_1898,419,426,7,419,1036,0.007
1899,task_1899,1207,1213,6,1206,1406,0.011
1900,task_1900,429,440,11,429,602,0.01
1901,task_1901,1147,1153,6,1145,1304,0.012
1902,task_1902,941,950,9,940,1188,0.013
1903,task_1903,950,964,14,950,994,0.006
1904,task_1904,15,21,6,11,1391,0.007
1905,task_1905,168,181,13,168,870,0.008
1906,task_1906,566,574,8,566,1219,0.013
1907,task_1907,231,241,10,231,277,0.014
1908,task_1908,796,801,5,793,1060,0.005
1909,task_1909,78,84,6,78,748,0.011
1910,task_1910,1017,1027,10,1007,1424,0.013
1911,task_1911,349,360,11,349,511,0.009
1912,task_1912,550,563,13,550,1204,0.013
1913,task_1913,669,680,11,649,1321,0.007
1914,task_1914,1268,1278,10,1268,1370,0.01
1915,task_1915,322,328,6,322,606,0.013
1916,task_1916,564,576,12,558,1180,0.009
1917,task_1917,173,181,8,172,1043,0.009
1918,task_1918,429,441,12,429,1304,0.008
1919,task_1919,878,890,12,878,945,0.008
1920,task_1920,801,810,9,800,1123,0.011
1921,task_1921,134,148,14,134,884,0.014
1922,task_1922,1357,1362,5,1177,1436,0.009
1923,task_1923,150,155,5,150,525,0.01
1924,task_1924,118,132,14,116,1319,0.008
1925,task_1925,187,195,8,187,481,0.007
1926,task_1926,428,441,13,428,488,0.013
1927,task_1927,1327,1341,14,1327,1409,0.006
1928,task_1928,1208,1215,7,1208,1316,0.012
1929,task_1929,427,434,7,427,847,0.01
1930,task_1930,525,539,14,524,719,0.008
1931,task_1931,492,497,5,486,1227,0.01
1932,task_1932,1094,1100,6,1094,1323,0.007
1933,task_1933,136,144,8,135,935,0.012
1934,task_1934,92,101,9,89,1306,0.009
1935,task_1935,143,151,8,143,169,0.009
1936,task_1936,230,236,6,229,1412,0.012
1937,task_1937,792,803,11,788,1150,0.011
1938,task_1938,409,417,8,409,1114,0.012
1939,task_1939,891,898,7,883,1342,0.006
1940,task_1940,763,768,5,763,1279,0.007
1941,task_1941,677,685,8,677,909,0.007
1942,task_1942,500,509,9,500,1160,0.013
1943,task_1943,1106,1116,10,1106,1210,0.012
1944,task_1944,855,865,10,855,1275,0.009
1945,task_1945,1036,1042,6,1032,1269,0.011
1946,task_1946,1077,1088,11,1077,1142,0.013
1947,task_1947,720,725,5,720,1227,0.012
1948,task_1948,974,981,7,932,1411,0.006
1949,task_1949,1318,1324,6,1314,1403,0.01
1950,task_1950,308,315,7,308,1048,0.012
1951,task_1951,1065,1073,8,1057,1404,0.011
1952,task_1952,99,107,8,99,787,0.014
1953,task_1953,603,612,9,482,1428,0.011
1954,task_1954,122,127,5,122,757,0.009
1955,task_1955,1209,1221,12,1209,1265,0.008
1956,task_1956,705,711,6,705,1058,0.009
1957,task_1957,983,996,13,980,1405,0.008
1958,task_1958,328,340,12,328,1048,0.009
1959,task_1959,1148,1161,13,1148,1365,0.008
1960,task_1960,288,293,5,288,888,0.012
1961,task_1961,502,516,14,502,546,0.009
1962,task_1962,1236,1241,5,1236,1351,0.005
1963,task_1963,979,984,5,978,1330,0.014
1964,task_1964,247,258,11,247,927,0.01
1965,task_1965,265,279,14,265,333,0.006
1966,task_1966,1395,1406,11,1395,1427,0.014
1967,task_1967,106,118,12,106,209,0.01
1968,task_1968,164,178,14,164,851,0.011
1969,task_1969,1317,1326,9,1317,1361,0.013
1970,task_1970,737,749,12,737,1119,0.014
1971,task_1971,1121,1134,13,1121,1368,0.009
1972,task_1972,1115,1122,7,1115,1191,0.006
1973,task_1973,1355,1365,10,1355,1385,0.007
1974,task_1974,402,416,14,396,1415,0.011
1975,task_1975,246,253,7,246,270,0.008
1976,task_1976,402,412,10,402,450,0.008
1977,task_1977,1240,1248,8,1240,1375,0.011
1978,task_1978,957,965,8,953,1364,0.006
1979,task_1979,749,754,5,748,958,0.013
1980,task_1980,579,584,5,579,662,0.008
1981,task_1981,1136,1141,5,1098,1407,0.008
1982,task_1982,936,943,7,935,1057,0.01
1983,task_1983,1005,1014,9,1003,1378,0.011
1984,task_1984,1334,1344,10,1333,1402,0.01
1985,task_1985,462,473,11,462,551,0.012
1986,task_1986,1299,1306,7,1298,1397,0.012
1987,task_1987,1044,1052,8,1044,1279,0.01
1988,task_1988,31,42,11,31,848,0.013
1989,task_1989,298,304,6,298,347,0.011
1990,task_1990,339,353,14,339,985,0.012
1991,task_1991,1036,1042,6,1033,1303,0.013
1992,task_1992,884,895,11,883,1245,0.013
1993,task_1993,588,593,5,588,867,0.005
1994,task_1994,495,501,6,495,644,0.014
1995,task_1995,468,474,6,468,1061,0.005
1996,task_1996,1394,1401,7,1392,1437,0.005
1997,task_1997,686,691,5,677,1409,0.012
1998,task_1998,1225,1236,11,885,1435,0.013
1999,task_1999,1246,1260,14,1246,1280,0.005
2000,task_2000,538,551,13,536,1233,0.007
2001,task_2001,907,913,6,907,1117,0.007
2002,task_2002,908,917,9,908,1186,0.011
2003,task_2003,390,395,5,390,1014,0.009
2004,task_2004,143,153,10,140,1030,0.009
2005,task_2005,1311,1319,8,1310,1404,0.014
2006,task_2006,372,377,5,358,1324,0.012
2007,task_2007,735,742,7,735,1305,0.014
2008,task_2008,1069,1074,5,1050,1408,0.013
2009,task_2009,1201,1208,7,1201,1257,0.005
2010,task_2010,1197,1209,12,1197,1290,0.008
2011,task_2011,628,634,6,623,1415,0.009
2012,task_2012,1375,1387,12,1375,1399,0.012
2013,task_2013,1121,1131,10,1121,1175,0.01
2014,task_2014,1095,1108,13,1092,1348,0.01
2015,task_2015,850,859,9,850,1185,0.014
2016,task_2016,597,608,11,597,807,0.012
2017,task_2017,1034,1043,9,1033,1115,0.006
2018,task_2018,372,379,7,363,1287,0.014
2019,task_2019,1046,1060,14,1046,1236,0.01
2020,task_2020,1004,1009,5,1004,1248,0.005
2021,task_2021,630,638,8,630,736,0.011
2022,task_2022,1367,1379,12,1367,1420,0.008
2023,task_2023,1015,1024,9,1015,1353,0.01
2024,task_2024,1263,1272,9,1263,1316,0.009
2025,task_2025,1235,1243,8,1234,1413,0.014
2026,task_2026,632,641,9,632,867,0.005
2027,task_2027,294,307,13,294,993,0.009
2028,task_2028,147,159,12,147,999,0.013
2029,task_2029,1332,1338,6,1332,1368,0.007
2030,task_2030,707,717,10,707,812,0.005
2031,task_2031,17,30,13,16,637,0.01
2032,task_2032,1396,1407,11,1396,1422,0.012
2033,task_2033,289,299,10,289,581,0.013
2034,task_2034,277,289,12,277,479,0.013
2035,task_2035,1179,1187,8,1167,1415,0.007
2036,task_2036,1124,1135,11,1123,1192,0.014
2037,task_2037,905,912,7,905,1175,0.007
2038,task_2038,44,56,12,44,938,0.009
2039,task_2039,1016,1027,11,1015,1418,0.005
2040,task_2040,783,792,9,783,993,0.011
2041,task_2041,342,350,8,342,911,0.011
2042,task_2042,769,774,5,736,1427,0.009
2043,task_2043,1222,1230,8,1220,1360,0.01
2044,task_2044,304,318,14,304,452,0.008
2045,task_2045,58,63,5,58,167,0.012
2046,task_2046,1080,1091,11,1077,1271,0.01
2047,task_2047,182,191,9,182,215,0.006
2048,task_2048,569,576,7,566,1354,0.013
2049,task_2049,3,14,11,3,49,0.009
2050,task_2050,837,842,5,832,1187,0.006
2051,task_2051,798,805,7,798,1012,0.011
2052,task_2052,1398,1406,8,1398,1424,0.012
2053,task_2053,996,1007,11,996,1319,0.012
2054,task_2054,1035,1043,8,1035,1131,0.012
2055,task_2055,824,836,12,824,1273,0.013
2056,task_2056,593,598,5,593,1134,0.005
2057,task_2057,1207,1218,11,1203,1415,0.007
2058,task_2058,98,108,10,98,1098,0.007
2059,task_2059,981,991,10,981,1276,0.011
2060,task_2060,381,388,7,380,769,0.009
2061,task_2061,868,878,10,866,1274,0.013
2062,task_2062,226,233,7,223,1332,0.006
2063,task_2063,636,647,11,635,759,0.012
2064,task_2064,354,364,10,354,645,0.011
2065,task_2065,1063,1068,5,1060,1345,0.013
2066,task_2066,504,515,11,504,1005,0.005
2067,task_2067,470,483,13,470,726,0.014
2068,task_2068,432,437,5,432,996,0.006
2069,task_2069,228,241,13,228,1144,0.013
2070,task_2070,673,679,6,672,880,0.012
2071,task_2071,1030,1039,9,1023,1313,0.006
2072,task_2072,1262,1269,7,1256,1423,0.008
2073,task_2073,592,603,11,592,1037,0.01
2074,task_2074,274,281,7,274,1225,0.009
2075,task_2075,1390,1403,13,1390,1424,0.014
2076,task_2076,146,157,11,146,293,0.013
2077,task_2077,973,980,7,973,1265,0.014
2078,task_2078,616,630,14,616,657,0.009
2079,task_2079,529,541,12,529,572,0.013
2080,task_2080,314,328,14,314,870,0.008
2081,task_2081,560,571,11,560,857,0.012
2082,task_2082,1306,1314,8,1303,1379,0.009
2083,task_2083,353,361,8,353,414,0.011
2084,task_2084,509,522,13,509,1082,0.01
2085,task_2085,464,473,9,464,639,0.013
2086,task_2086,418,428,10,418,1409,0.012
2087,task_2087,479,484,5,479,1435,0.006
2088,task_2088,1288,1302,14,1288,1373,0.012
2089,task_2089,586,592,6,547,1397,0.012
2090,task_2090,878,889,11,878,1151,0.013
2091,task_2091,823,831,8,821,1098,0.012
2092,task_2092,281,290,9,281,921,0.011
2093,task_2093,93,106,13,87,1389,0.008
2094,task_2094,1334,1341,7,1334,1393,0.012
2095,task_2095,1251,1260,9,1251,1321,0.013
2096,task_2096,1137,1146,9,1137,1361,0.014
2097,task_2097,192,197,5,191,618,0.008
2098,task_2098,1362,1367,5,1239,1437,0.008
2099,task_2099,1317,1323,6,1316,1363,0.008
2100,task_2100,644,658,14,643,1363,0.011
2101,task_2101,571,581,10,571,1267,0.007
2102,task_2102,1387,1401,14,1385,1431,0.005
2103,task_2103,728,734,6,728,1395,0.012
2104,task_2104,744,756,12,741,1402,0.011
2105,task_2105,1309,1321,12,1309,1335,0.013
2106,task_2106,862,869,7,782,1384,0.013
2107,task_2107,856,868,12,851,1311,0.005
2108,task_2108,160,173,13,160,1155,0.008
2109,task_2109,1048,1060,12,1048,1253,0.009
2110,task_2110,825,839,14,825,995,0.011
2111,task_2111,1391,1397,6,1391,1410,0.011
2112,task_2112,525,537,12,525,581,0.009
2113,task_2113,895,905,10,890,1383,0.005
2114,task_2114,526,532,6,524,866,0.011
2115,task_2115,1357,1362,5,971,1436,0.006
2116,task_2116,1383,1389,6,1383,1424,0.013
2117,task_2117,20,34,14,20,906,0.009
2118,task_2118,406,411,5,406,1052,0.009
2119,task_2119,291,296,5,291,1333,0.014
2120,task_2120,1047,1060,13,1047,1255,0.007
2121,task_2121,453,461,8,453,627,0.007
2122,task_2122,1198,1206,8,1198,1358,0.009
2123,task_2123,550,556,6,549,1150,0.009
2124,task_2124,1370,1383,13,1367,1429,0.008
2125,task_2125,880,892,12,880,986,0.01
2126,task_2126,506,512,6,506,858,0.012
2127,task_2127,245,250,5,245,484,0.007
2128,task_2128,1091,1097,6,1089,1215,0.011
2129,task_2129,339,345,6,339,492,0.01
2130,task_2130,406,411,5,406,777,0.011
2131,task_2131,159,173,14,159,703,0.012
2132,task_2132,1148,1154,6,1148,1276,0.007
2133,task_2133,1367,1378,11,1367,1405,0.006
2134,task_2134,432,439,7,432,673,0.008
2135,task_2135,306,316,10,301,1242,0.009
2136,task_2136,356,361,5,356,1101,0.007
2137,task_2137,1000,1005,5,1000,1068,0.006
2138,task_2138,736,750,14,736,1153,0.008
2139,task_2139,1113,1124,11,1113,1147,0.013
2140,task_2140,995,1009,14,993,1281,0.007
2141,task_2141,79,88,9,79,125,0.014
2142,task_2142,1042,1055,13,1042,1170,0.005
2143,task_2143,1362,1367,5,544,1437,0.005
2144,task_2144,469,476,7,469,1255,0.007
2145,task_2145,1273,1286,13,1273,1305,0.01
2146,task_2146,369,377,8,369,653,0.009
2147,task_2147,749,762,13,749,1105,0.009
2148,task_2148,545,552,7,545,865,0.009
2149,task_2149,684,698,14,681,1294,0.011
2150,task_2150,511,523,12,511,554,0.008
2151,task_2151,1358,1365,7,1358,1396,0.005
2152,task_2152,391,397,6,391,1118,0.007
2153,task_2153,328,339,11,328,529,0.005
2154,task_2154,668,681,13,666,1264,0.006
2155,task_2155,971,984,13,971,1214,0.006
2156,task_2156,1152,1161,9,1152,1185,0.005
2157,task_2157,950,962,12,950,1196,0.012
2158,task_2158,998,1007,9,998,1103,0.005
2159,task_2159,417,426,9,417,1339,0.005
2160,task_2160,473,482,9,473,527,0.01
2161,task_2161,715,721,6,714,1175,0.014
2162,task_2162,692,698,6,688,1296,0.009
2163,task_2163,1151,1157,6,1145,1368,0.01
2164,task_2164,414,423,9,414,814,0.011
2165,task_2165,404,415,11,404,1180,0.011
2166,task_2166,104,113,9,103,618,0.013
2167,task_2167,1023,1030,7,1023,1087,0.008
2168,task_2168,171,180,9,171,545,0.005
2169,task_2169,638,644,6,638,1376,0.008
2170,task_2170,1218,1229,11,1066,1432,0.009
2171,task_2171,390,397,7,390,616,0.012
2172,task_2172,1302,1307,5,1302,1377,0.011
2173,task_2173,1019,1030,11,1019,1296,0.011
2174,task_2174,1294,1306,12,1294,1348,0.013
2175,task_2175,261,268,7,261,1134,0.012
2176,task_2176,1096,1110,14,1096,1301,0.012
2177,task_2177,1305,1317,12,1305,1349,0.011
2178,task_2178,663,677,14,661,1162,0.005
2179,task_2179,399,410,11,399,546,0.01
2180,task_2180,668,677,9,668,854,0.007
2181,task_2181,993,1001,8,993,1098,0.01
2182,task_2182,87,100,13,87,1116,0.014
2183,task_2183,861,866,5,837,1371,0.009
2184,task_2184,1396,1405,9,1396,1429,0.007
2185,task_2185,834,844,10,834,975,0.01
2186,task_2186,1250,1257,7,1245,1412,0.014
2187,task_2187,615,627,12,615,1141,0.009
2188,task_2188,630,642,12,630,826,0.014
2189,task_2189,734,747,13,734,1183,0.012
2190,task_2190,1137,1144,7,1137,1408,0.005
2191,task_2191,966,979,13,966,1077,0.008
2192,task_2192,602,609,7,602,1237,0.011
2193,task_2193,786,795,9,785,1212,0.014
2194,task_2194,237,251,14,237,913,0.009
2195,task_2195,513,518,5,512,1006,0.009
2196,task_2196,1279,1293,14,1279,1364,0.006
2197,task_2197,1226,1239,13,908,1437,0.009
2198,task_2198,307,316,9,293,1369,0.006
2199,task_2199,1250,1264,14,1244,1423,0.009
2200,task_2200,57,62,5,57,1180,0.013
2201,task_2201,860,867,7,860,1096,0.008
2202,task_2202,1355,1362,7,1355,1389,0.01
2203,task_2203,782,791,9,782,1030,0.007
2204,task_2204,635,641,6,635,713,0.006
2205,task_2205,481,495,14,481,671,0.012
2206,task_2206,1237,1249,12,1237,1331,0.011
2207,task_2207,1302,1308,6,1298,1421,0.009
2208,task_2208,204,215,11,204,299,0.011
2209,task_2209,178,185,7,178,1083,0.009
2210,task_2210,1030,1041,11,1030,1254,0.011
2211,task_2211,206,215,9,205,1139,0.01
2212,task_2212,910,917,7,910,1177,0.009
2213,task_2213,588,593,5,588,1033,0.008
2214,task_2214,436,450,14,436,665,0.008
2215,task_2215,965,976,11,933,1414,0.008
2216,task_2216,105,116,11,104,828,0.01
2217,task_2217,1018,1030,12,805,1426,0.007
2218,task_2218,188,196,8,188,965,0.006
2219,task_2219,25,30,5,25,810,0.01
2220,task_2220,1242,1255,13,1242,1272,0.008
2221,task_2221,1043,1055,12,1043,1144,0.007
2222,task_2222,420,433,13,420,735,0.014
2223,task_2223,925,930,5,923,1383,0.005
2224,task_2224,527,540,13,506,1325,0.01
2225,task_2225,1095,1103,8,1087,1391,0.008
2226,task_2226,956,965,9,950,1347,0.01
2227,task_2227,641,648,7,641,779,0.007
2228,task_2228,591,605,14,590,976,0.009
2229,task_2229,1236,1242,6,1236,1264,0.007
2230,task_2230,814,825,11,803,1327,0.013
2231,task_2231,999,1007,8,999,1195,0.011
2232,task_2232,500,507,7,500,768,0.009
2233,task_2233,404,415,11,404,895,0.01
2234,task_2234,490,504,14,489,1178,0.005
2235,task_2235,342,355,13,342,400,0.009
2236,task_2236,350,355,5,350,718,0.007
2237,task_2237,839,849,10,832,1249,0.013
2238,task_2238,489,503,14,488,829,0.007
2239,task_2239,1039,1047,8,1039,1339,0.007
2240,task_2240,433,439,6,433,655,0.005
2241,task_2241,1054,1059,5,1054,1374,0.005
2242,task_2242,1028,1039,11,1028,1054,0.013
2243,task_2243,926,937,11,884,1409,0.013
2244,task_2244,786,798,12,784,1238,0.007
2245,task_2245,1153,1167,14,1152,1357,0.012
2246,task_2246,1015,1025,10,1015,1218,0.013
2247,task_2247,959,970,11,959,1359,0.01
2248,task_2248,1389,1394,5,1389,1409,0.005
2249,task_2249,526,533,7,518,1306,0.005
2250,task_2250,723,733,10,722,1353,0.009
2251,task_2251,1217,1227,10,1217,1272,0.012
2252,task_2252,751,757,6,747,1293,0.008
2253,task_2253,479,484,5,479,726,0.013
2254,task_2254,1307,1318,11,1306,1392,0.008
2255,task_2255,934,946,12,933,1267,0.013
2256,task_2256,576,588,12,570,1368,0.01
2257,task_2257,983,989,6,982,1358,0.011
2258,task_2258,912,925,13,911,1118,0.006
2259,task_2259,661,675,14,660,744,0.009
2260,task_2260,658,671,13,657,1173,0.012
2261,task_2261,189,202,13,189,953,0.01
2262,task_2262,515,521,6,512,1265,0.011
2263,task_2263,112,124,12,112,322,0.007
2264,task_2264,86,93,7,86,587,0.009
2265,task_2265,981,986,5,981,1180,0.014
2266,task_2266,1069,1079,10,1069,1217,0.007
2267,task_2267,915,926,11,915,1161,0.008
2268,task_2268,665,678,13,665,867,0.014
2269,task_2269,1275,1285,10,1274,1369,0.005
2270,task_2270,97,109,12,97,144,0.006
2271,task_2271,898,905,7,898,989,0.01
2272,task_2272,564,576,12,564,672,0.009
2273,task_2273,709,722,13,703,1264,0.008
2274,task_2274,1092,1106,14,1091,1279,0.013
2275,task_2275,495,507,12,495,682,0.011
2276,task_2276,1152,1158,6,1152,1188,0.006
2277,task_2277,70,84,14,70,335,0.011
2278,task_2278,1380,1389,9,1380,1430,0.006
2279,task_2279,1353,1362,9,1353,1418,0.011
2280,task_2280,1027,1035,8,1027,1271,0.012
2281,task_2281,1213,1218,5,1212,1379,0.014
2282,task_2282,1383,1393,10,1383,1415,0.009
2283,task_2283,1267,1277,10,1266,1397,0.01
2284,task_2284,818,832,14,818,1134,0.007
2285,task_2285,1290,1302,12,1290,1383,0.013
2286,task_2286,1227,1238,11,1227,1427,0.013
2287,task_2287,700,706,6,700,1094,0.012
2288,task_2288,1381,1388,7,1381,1431,0.014
2289,task_2289,0,6,6,0,1030,0.014
2290,task_2290,662,676,14,660,773,0.014
2291,task_2291,1224,1238,14,1224,1288,0.01
2292,task_2292,806,811,5,801,1261,0.008
2293,task_2293,145,158,13,144,1003,0.006
2294,task_2294,219,228,9,219,345,0.008
2295,task_2295,802,812,10,802,926,0.005
2296,task_2296,1054,1061,7,1052,1269,0.014
2297,task_2297,104,113,9,102,629,0.012
2298,task_2298,486,496,10,483,1057,0.013
2299,task_2299,299,308,9,299,457,0.009
2300,task_2300,26,38,12,26,331,0.01
2301,task_2301,1237,1242,5,1237,1316,0.006
2302,task_2302,1380,1388,8,1379,1430,0.008
2303,task_2303,642,656,14,642,772,0.011
2304,task_2304,910,922,12,910,1132,0.011
2305,task_2305,506,514,8,506,828,0.009
2306,task_2306,636,642,6,635,1147,0.011
2307,task_2307,379,391,12,361,1407,0.005
2308,task_2308,1287,1293,6,1285,1375,0.008
2309,task_2309,1045,1056,11,1045,1132,0.008
2310,task_2310,338,350,12,338,716,0.009
2311,task_2311,446,454,8,446,663,0.009
2312,task_2312,665,674,9,665,921,0.01
2313,task_2313,168,174,6,166,873,0.012
2314,task_2314,385,393,8,383,1280,0.009
2315,task_2315,365,372,7,364,907,0.012
2316,task_2316,312,318,6,309,651,0.009
2317,task_2317,1203,1217,14,1203,1327,0.01
2318,task_2318,909,917,8,909,1076,0.012
2319,task_2319,1350,1361,11,1316,1438,0.007
2320,task_2320,878,892,14,803,1395,0.014
2321,task_2321,1323,1335,12,1323,1365,0.013
2322,task_2322,185,190,5,185,650,0.013
2323,task_2323,367,373,6,350,1259,0.007
2324,task_2324,970,976,6,970,1176,0.008
2325,task_2325,774,786,12,772,1109,0.007
2326,task_2326,1164,1175,11,1162,1343,0.012
2327,task_2327,24,30,6,21,974,0.012
2328,task_2328,393,402,9,391,1295,0.013
2329,task_2329,849,862,13,849,947,0.014
2330,task_2330,1254,1263,9,1248,1420,0.014
2331,task_2331,437,445,8,437,1255,0.008
2332,task_2332,770,775,5,770,1049,0.008
2333,task_2333,214,223,9,214,488,0.006
2334,task_2334,734,748,14,732,1404,0.01
2335,task_2335,845,856,11,845,1116,0.005
2336,task_2336,14,25,11,14,1146,0.012
2337,task_2337,1054,1068,14,1054,1193,0.009
2338,task_2338,365,370,5,365,849,0.012
2339,task_2339,1363,1369,6,1363,1419,0.013
2340,task_2340,1209,1216,7,1209,1305,0.008
2341,task_2341,248,256,8,248,402,0.007
2342,task_2342,938,949,11,938,1085,0.013
2343,task_2343,973,982,9,966,1370,0.009
2344,task_2344,354,365,11,354,729,0.005
2345,task_2345,1205,1219,14,1205,1259,0.014
2346,task_2346,1006,1015,9,1006,1378,0.011
2347,task_2347,550,559,9,550,996,0.007
2348,task_2348,213,227,14,213,711,0.005
2349,task_2349,1276,1286,10,1276,1326,0.013
2350,task_2350,390,396,6,390,664,0.011
2351,task_2351,706,716,10,702,1209,0.006
2352,task_2352,430,443,13,430,1385,0.014
2353,task_2353,705,717,12,702,1191,0.014
2354,task_2354,1009,1018,9,1008,1165,0.014
2355,task_2355,193,205,12,192,824,0.012
2356,task_2356,1373,1381,8,1373,1410,0.012
2357,task_2357,974,979,5,968,1411,0.013
2358,task_2358,291,304,13,291,354,0.008
2359,task_2359,1303,1317,14,1303,1358,0.01
2360,task_2360,347,354,7,347,1289,0.013
2361,task_2361,937,946,9,935,1202,0.014
2362,task_2362,604,610,6,604,844,0.011
2363,task_2363,1169,1176,7,1168,1269,0.01
2364,task_2364,868,873,5,865,1252,0.008
2365,task_2365,872,886,14,871,1288,0.014
2366,task_2366,591,604,13,591,766,0.013
2367,task_2367,1131,1145,14,1129,1382,0.011
2368,task_2368,1311,1318,7,1311,1380,0.007
2369,task_2369,8,16,8,8,450,0.009
2370,task_2370,819,824,5,818,1299,0.011
2371,task_2371,311,325,14,311,368,0.01
2372,task_2372,197,206,9,197,588,0.013
2373,task_2373,774,787,13,774,1033,0.01
2374,task_2374,806,817,11,798,1270,0.005
2375,task_2375,65,76,11,64,1256,0.011
2376,task_2376,1197,1211,14,1185,1367,0.01
2377,task_2377,3,9,6,3,498,0.008
2378,task_2378,4,18,14,4,756,0.009
2379,task_2379,1387,1393,6,1386,1425,0.007
2380,task_2380,1399,1407,8,1399,1425,0.007
2381,task_2381,289,294,5,289,704,0.013
2382,task_2382,350,362,12,350,816,0.007
2383,task_2383,837,844,7,836,1126,0.01
2384,task_2384,974,986,12,860,1417,0.008
2385,task_2385,876,884,8,876,950,0.011
2386,task_2386,1326,1336,10,1326,1354,0.012
2387,task_2387,367,379,12,363,1271,0.01
2388,task_2388,89,103,14,89,247,0.012
2389,task_2389,735,740,5,735,800,0.008
2390,task_2390,969,981,12,969,1154,0.008
2391,task_2391,1124,1132,8,1124,1348,0.009
2392,task_2392,957,965,8,957,1019,0.009
2393,task_2393,1246,1257,11,1246,1323,0.01
2394,task_2394,711,720,9,710,977,0.012
2395,task_2395,400,413,13,400,681,0.011
2396,task_2396,1095,1103,8,1095,1371,0.008
2397,task_2397,1014,1022,8,1014,1247,0.007
2398,task_2398,166,177,11,166,619,0.013
2399,task_2399,154,159,5,153,1041,0.012
2400,task_2400,873,878,5,873,1119,0.013
2401,task_2401,638,644,6,638,833,0.014
2402,task_2402,1291,1300,9,1291,1325,0.014
2403,task_2403,1258,1270,12,1258,1283,0.009
2404,task_2404,977,985,8,977,1177,0.012
2405,task_2405,299,307,8,299,803,0.011
2406,task_2406,656,665,9,656,1153,0.012
2407,task_2407,133,143,10,131,1341,0.006
2408,task_2408,851,860,9,851,871,0.011
2409,task_2409,649,656,7,649,686,0.009
2410,task_2410,1032,1037,5,1032,1048,0.012
2411,task_2411,766,778,12,766,1201,0.013
2412,task_2412,350,364,14,350,525,0.007
2413,task_2413,257,271,14,257,316,0.014
2414,task_2414,1224,1231,7,1224,1402,0.006
2415,task_2415,1250,1262,12,1250,1361,0.008
2416,task_2416,1386,1391,5,1386,1408,0.014
2417,task_2417,995,1008,13,993,1173,0.011
2418,task_2418,758,768,10,746,1416,0.012
2419,task_2419,0,7,7,0,930,0.013
2420,task_2420,713,722,9,712,880,0.005
2421,task_2421,933,943,10,929,1190,0.014
2422,task_2422,324,334,10,324,1022,0.007
2423,task_2423,1226,1231,5,1226,1392,0.005
2424,task_2424,345,354,9,345,834,0.007
2425,task_2425,760,767,7,760,825,0.005
2426,task_2426,1359,1367,8,1359,1390,0.008
2427,task_2427,302,316,14,302,1176,0.011
2428,task_2428,54,67,13,54,323,0.005
2429,task_2429,1025,1039,14,1025,1120,0.005
2430,task_2430,859,868,9,858,1360,0.007
2431,task_2431,407,414,7,407,1147,0.01
2432,task_2432,1333,1344,11,1333,1381,0.013
2433,task_2433,28,35,7,28,341,0.008
2434,task_2434,902,915,13,902,1155,0.005
2435,task_2435,874,885,11,786,1391,0.013
2436,task_2436,602,615,13,518,1427,0.012
2437,task_2437,546,554,8,546,980,0.012
2438,task_2438,1343,1354,11,1343,1378,0.012
2439,task_2439,1124,1134,10,1083,1411,0.008
2440,task_2440,11,20,9,11,1255,0.007
2441,task_2441,709,722,13,708,1293,0.013
2442,task_2442,227,234,7,227,550,0.009
2443,task_2443,463,468,5,463,890,0.01
2444,task_2444,800,805,5,800,830,0.011
2445,task_2445,682,693,11,682,941,0.008
2446,task_2446,537,548,11,536,1167,0.011
2447,task_2447,494,504,10,494,788,0.011
2448,task_2448,396,406,10,396,847,0.005
2449,task_2449,1029,1043,14,1023,1313,0.014
2450,task_2450,1066,1072,6,1050,1407,0.008
2451,task_2451,63,68,5,61,912,0.005
2452,task_2452,664,674,10,664,727,0.013
2453,task_2453,119,131,12,119,684,0.013
2454,task_2454,412,423,11,412,1230,0.01
2455,task_2455,1015,1020,5,1015,1386,0.008
2456,task_2456,110,120,10,110,710,0.013
2457,task_2457,830,843,13,830,1034,0.009
2458,task_2458,1110,1121,11,1110,1208,0.011
2459,task_2459,281,289,8,281,1275,0.013
2460,task_2460,1101,1113,12,1100,1261,0.012
2461,task_2461,55,61,6,55,1121,0.013
2462,task_2462,105,118,13,104,1316,0.005
2463,task_2463,291,302,11,291,1206,0.008
2464,task_2464,806,816,10,784,1268,0.011
2465,task_2465,84,92,8,84,308,0.007
2466,task_2466,1085,1099,14,1084,1212,0.007
2467,task_2467,1318,1327,9,1317,1390,0.011
2468,task_2468,587,593,6,587,1069,0.007
2469,task_2469,722,734,12,722,775,0.006
2470,task_2470,1400,1405,5,1392,1435,0.007
2471,task_2471,768,779,11,734,1431,0.013
2472,task_2472,944,958,14,944,1092,0.012
2473,task_2473,1387,1395,8,1387,1429,0.006
2474,task_2474,557,567,10,557,1159,0.011
2475,task_2475,1154,1164,10,1154,1288,0.009
2476,task_2476,774,779,5,772,1073,0.01
2477,task_2477,616,621,5,616,1009,0.009
2478,task_2478,545,559,14,545,655,0.008
2479,task_2479,357,366,9,357,720,0.01
2480,task_2480,797,804,7,797,1095,0.012
2481,task_2481,1296,1307,11,1288,1419,0.013
2482,task_2482,1090,1095,5,1090,1161,0.014
2483,task_2483,148,158,10,146,1214,0.012
2484,task_2484,1196,1209,13,1196,1244,0.014
2485,task_2485,45,58,13,45,302,0.007
2486,task_2486,1138,1143,5,1109,1416,0.01
2487,task_2487,387,400,13,366,1428,0.01
2488,task_2488,1301,1307,6,1301,1386,0.008
2489,task_2489,408,414,6,408,1106,0.007
2490,task_2490,481,486,5,481,572,0.007
2491,task_2491,984,994,10,984,1005,0.01
2492,task_2492,859,866,7,859,971,0.009
2493,task_2493,301,315,14,300,1120,0.013
2494,task_2494,402,408,6,402,439,0.006
2495,task_2495,309,316,7,309,494,0.013
2496,task_2496,31,40,9,31,1393,0.005
2497,task_2497,398,409,11,398,617,0.014
2498,task_2498,64,72,8,64,445,0.011
2499,task_2499,1107,1118,11,1107,1188,0.009
2500,task_2500,1230,1240,10,1230,1428,0.014
2501,task_2501,18,31,13,18,407,0.014
2502,task_2502,339,353,14,339,1244,0.009
2503,task_2503,742,755,13,740,1345,0.007
2504,task_2504,958,966,8,958,1146,0.008
2505,task_2505,245,252,7,245,1382,0.009
2506,task_2506,110,118,8,110,151,0.014
2507,task_2507,711,716,5,710,887,0.007
2508,task_2508,839,850,11,839,924,0.01
2509,task_2509,840,853,13,837,1286,0.006
2510,task_2510,1211,1217,6,916,1426,0.007
2511,task_2511,74,80,6,74,1249,0.007
2512,task_2512,887,894,7,887,1053,0.01
2513,task_2513,726,735,9,695,1374,0.014
2514,task_2514,651,664,13,651,948,0.008
2515,task_2515,1142,1147,5,1141,1319,0.013
2516,task_2516,822,827,5,822,899,0.007
2517,task_2517,1200,1211,11,1190,1400,0.012
2518,task_2518,1060,1070,10,1060,1172,0.009
2519,task_2519,597,606,9,597,1176,0.006
2520,task_2520,208,217,9,208,709,0.01
2521,task_2521,937,942,5,936,1169,0.011
2522,task_2522,425,438,13,425,1240,0.011
2523,task_2523,884,890,6,884,1197,0.013
2524,task_2524,984,991,7,973,1414,0.009
2525,task_2525,1111,1120,9,1111,1323,0.012
2526,task_2526,1152,1163,11,1152,1233,0.008
2527,task_2527,1371,1376,5,1370,1431,0.005
2528,task_2528,746,759,13,745,1205,0.011
2529,task_2529,1368,1380,12,1368,1392,0.014
2530,task_2530,120,130,10,119,882,0.007
2531,task_2531,281,288,7,281,1359,0.007
2532,task_2532,1390,1404,14,1389,1437,0.013
2533,task_2533,979,988,9,979,1108,0.012
2534,task_2534,1001,1007,6,996,1412,0.008
2535,task_2535,296,302,6,293,1149,0.012
2536,task_2536,686,692,6,664,1407,0.013
2537,task_2537,294,301,7,292,1026,0.008
2538,task_2538,656,670,14,650,1237,0.013
2539,task_2539,502,513,11,494,1221,0.007
2540,task_2540,757,770,13,755,1371,0.01
2541,task_2541,447,460,13,447,528,0.014
2542,task_2542,1184,1194,10,1184,1412,0.006
2543,task_2543,93,100,7,93,906,0.012
2544,task_2544,161,174,13,161,761,0.005
2545,task_2545,1031,1043,12,1030,1355,0.006
2546,task_2546,429,443,14,429,879,0.012
2547,task_2547,1394,1399,5,1394,1423,0.005
2548,task_2548,968,974,6,966,1320,0.01
2549,task_2549,1041,1047,6,1041,1197,0.011
2550,task_2550,645,653,8,631,1422,0.005
2551,task_2551,15,28,13,13,1226,0.012
2552,task_2552,1007,1020,13,1007,1371,0.011
2553,task_2553,1344,1351,7,1342,1432,0.012
2554,task_2554,843,849,6,843,866,0.008
2555,task_2555,1307,1319,12,1306,1400,0.009
2556,task_2556,456,465,9,456,852,0.009
2557,task_2557,915,924,9,915,1143,0.006
2558,task_2558,289,298,9,289,767,0.014
2559,task_2559,1341,1351,10,1341,1364,0.008
2560,task_2560,665,675,10,665,1018,0.01
2561,task_2561,425,433,8,425,796,0.008
2562,task_2562,529,537,8,528,1129,0.005
2563,task_2563,645,654,9,640,1423,0.013
2564,task_2564,113,123,10,112,747,0.011
2565,task_2565,4,15,11,4,1339,0.014
2566,task_2566,1330,1340,10,1306,1434,0.007
2567,task_2567,558,569,11,558,791,0.005
2568,task_2568,245,251,6,245,544,0.005
2569,task_2569,312,319,7,311,1150,0.01
2570,task_2570,675,682,7,674,1078,0.013
2571,task_2571,1194,1205,11,1194,1234,0.013
2572,task_2572,530,538,8,492,1361,0.005
2573,task_2573,1344,1358,14,1324,1439,0.01
2574,task_2574,449,459,10,449,813,0.01
2575,task_2575,634,645,11,632,1367,0.007
2576,task_2576,1158,1165,7,1158,1311,0.014
2577,task_2577,695,705,10,695,795,0.01
2578,task_2578,530,536,6,530,1260,0.008
2579,task_2579,711,723,12,710,891,0.01
2580,task_2580,1130,1138,8,1130,1241,0.01
2581,task_2581,290,296,6,290,749,0.008
2582,task_2582,260,265,5,260,585,0.01
2583,task_2583,965,977,12,965,1286,0.014
2584,task_2584,1045,1059,14,1045,1233,0.007
2585,task_2585,1277,1288,11,1277,1318,0.012
2586,task_2586,503,513,10,503,536,0.005
2587,task_2587,206,217,11,206,391,0.01
2588,task_2588,45,52,7,45,382,0.005
2589,task_2589,425,439,14,425,1125,0.007
2590,task_2590,228,241,13,228,398,0.011
2591,task_2591,849,857,8,849,990,0.008
2592,task_2592,197,210,13,197,318,0.01
2593,task_2593,735,745,10,735,883,0.007
2594,task_2594,992,1003,11,991,1207,0.011
2595,task_2595,708,718,10,708,849,0.006
2596,task_2596,1007,1017,10,929,1423,0.01
2597,task_2597,955,969,14,955,1229,0.007
2598,task_2598,521,526,5,519,732,0.008
2599,task_2599,963,972,9,840,1407,0.014
2600,task_2600,446,454,8,446,1390,0.008
2601,task_2601,59,72,13,59,523,0.008
2602,task_2602,792,800,8,789,1255,0.012
2603,task_2603,378,390,12,378,1038,0.012
2604,task_2604,341,354,13,341,1367,0.006
2605,task_2605,804,814,10,799,1228,0.014
2606,task_2606,80,87,7,80,1414,0.013
2607,task_2607,223,236,13,223,576,0.009
2608,task_2608,1064,1076,12,1061,1385,0.01
2609,task_2609,757,771,14,747,1413,0.014
2610,task_2610,798,809,11,798,854,0.014
2611,task_2611,224,237,13,224,1196,0.014
2612,task_2612,1069,1075,6,1069,1118,0.009
2613,task_2613,30,39,9,28,1233,0.006
2614,task_2614,830,841,11,830,860,0.014
2615,task_2615,96,103,7,94,1404,0.008
2616,task_2616,939,947,8,930,1318,0.01
2617,task_2617,496,501,5,496,947,0.014
2618,task_2618,1126,1139,13,1126,1278,0.007
2619,task_2619,895,909,14,889,1390,0.013
2620,task_2620,1076,1081,5,915,1422,0.008
2621,task_2621,294,307,13,294,965,0.014
2622,task_2622,351,357,6,351,523,0.01
2623,task_2623,183,193,10,183,891,0.011
2624,task_2624,367,372,5,365,1117,0.012
2625,task_2625,743,753,10,743,1206,0.009
2626,task_2626,744,758,14,742,1429,0.008
2627,task_2627,543,557,14,543,1131,0.012
2628,task_2628,52,66,14,52,1298,0.014
2629,task_2629,1166,1171,5,1166,1194,0.013
2630,task_2630,657,669,12,657,707,0.013
2631,task_2631,1116,1125,9,1116,1278,0.005
2632,task_2632,595,609,14,595,1014,0.012
2633,task_2633,971,978,7,967,1360,0.01
2634,task_2634,1099,1110,11,1099,1131,0.01
2635,task_2635,354,361,7,353,1072,0.006
2636,task_2636,581,586,5,581,953,0.01
2637,task_2637,847,853,6,834,1347,0.007
2638,task_2638,37,45,8,37,478,0.008
2639,task_2639,141,153,12,141,857,0.008
2640,task_2640,932,938,6,932,1062,0.008
2641,task_2641,723,730,7,723,1174,0.011
2642,task_2642,27,33,6,27,1002,0.006
2643,task_2643,1380,1386,6,1380,1413,0.007
2644,task_2644,470,481,11,470,524,0.007
2645,task_2645,1188,1193,5,1186,1325,0.008
2646,task_2646,1042,1052,10,1041,1208,0.005
2647,task_2647,1212,1219,7,1212,1331,0.01
2648,task_2648,575,582,7,564,1354,0.007
2649,task_2649,84,94,10,84,750,0.008
2650,task_2650,817,829,12,812,1359,0.007
2651,task_2651,254,263,9,254,1081,0.008
2652,task_2652,887,895,8,883,1298,0.013
2653,task_2653,690,703,13,690,771,0.011
2654,task_2654,646,654,8,646,924,0.005
2655,task_2655,78,87,9,78,1057,0.009
2656,task_2656,154,167,13,151,1292,0.012
2657,task_2657,1165,1172,7,1165,1362,0.005
2658,task_2658,738,752,14,738,821,0.011
2659,task_2659,257,265,8,257,812,0.009
2660,task_2660,111,125,14,110,822,0.009
2661,task_2661,1399,1409,10,1399,1432,0.005
2662,task_2662,1188,1197,9,1187,1299,0.005
2663,task_2663,868,880,12,865,1258,0.01
2664,task_2664,501,510,9,501,593,0.014
2665,task_2665,154,160,6,151,1127,0.011
2666,task_2666,1011,1025,14,1011,1185,0.011
2667,task_2667,561,575,14,561,650,0.014
2668,task_2668,1271,1279,8,1271,1304,0.006
2669,task_2669,849,863,14,845,1363,0.006
2670,task_2670,235,242,7,203,1424,0.008
2671,task_2671,739,749,10,738,1043,0.011
2672,task_2672,856,862,6,855,1306,0.014
2673,task_2673,620,631,11,619,873,0.01
2674,task_2674,492,499,7,492,1198,0.011
2675,task_2675,168,178,10,165,899,0.005
2676,task_2676,1239,1252,13,1239,1324,0.011
2677,task_2677,844,855,11,844,1101,0.01
2678,task_2678,544,554,10,544,1048,0.011
2679,task_2679,397,410,13,397,1089,0.01
2680,task_2680,725,730,5,703,1368,0.01
2681,task_2681,492,504,12,491,1166,0.014
2682,task_2682,275,283,8,275,850,0.012
2683,task_2683,581,588,7,581,878,0.012
2684,task_2684,363,369,6,362,1184,0.009
2685,task_2685,870,875,5,867,1367,0.008
2686,task_2686,1044,1051,7,1044,1248,0.013
2687,task_2687,106,114,8,106,1367,0.011
2688,task_2688,806,817,11,784,1270,0.012
2689,task_2689,123,137,14,123,589,0.011
2690,task_2690,1373,1378,5,1373,1411,0.01
2691,task_2691,299,309,10,298,1039,0.005
2692,task_2692,215,224,9,215,854,0.013
2693,task_2693,305,312,7,305,1178,0.007
2694,task_2694,1022,1027,5,1022,1149,0.012
2695,task_2695,207,221,14,207,435,0.005
2696,task_2696,1354,1362,8,1354,1389,0.014
2697,task_2697,1112,1119,7,1112,1317,0.009
2698,task_2698,733,742,9,732,1307,0.005
2699,task_2699,354,365,11,352,1058,0.008
2700,task_2700,1313,1325,12,1312,1360,0.014
2701,task_2701,698,704,6,697,1161,0.007
2702,task_2702,1293,1303,10,1293,1417,0.007
2703,task_2703,1254,1266,12,1254,1276,0.012
2704,task_2704,615,625,10,606,1184,0.005
2705,task_2705,226,240,14,226,435,0.011
2706,task_2706,1281,1287,6,1280,1334,0.009
2707,task_2707,892,900,8,892,1195,0.012
2708,task_2708,1189,1196,7,1189,1235,0.012
2709,task_2709,369,381,12,368,1014,0.007
2710,task_2710,402,409,7,395,1411,0.01
2711,task_2711,813,818,5,813,1215,0.008
2712,task_2712,576,584,8,576,965,0.012
2713,task_2713,954,962,8,954,1077,0.008
2714,task_2714,391,397,6,391,716,0.007
2715,task_2715,183,196,13,183,630,0.007
2716,task_2716,409,416,7,408,1349,0.008
2717,task_2717,1095,1105,10,1093,1343,0.014
2718,task_2718,600,610,10,599,1149,0.014
2719,task_2719,363,375,12,363,770,0.014
2720,task_2720,727,733,6,727,923,0.006
2721,task_2721,618,630,12,618,986,0.014
2722,task_2722,507,520,13,507,604,0.006
2723,task_2723,68,77,9,68,1358,0.008
2724,task_2724,1000,1014,14,1000,1063,0.01
2725,task_2725,565,578,13,560,1217,0.012
2726,task_2726,1035,1049,14,1032,1199,0.013
2727,task_2727,208,216,8,205,1302,0.014
2728,task_2728,533,541,8,533,741,0.007
2729,task_2729,847,860,13,842,1350,0.007
2730,task_2730,663,676,13,662,957,0.007
2731,task_2731,870,884,14,819,1391,0.013
2732,task_2732,382,392,10,381,1089,0.005
2733,task_2733,631,645,14,631,1174,0.012
2734,task_2734,101,112,11,101,787,0.005
2735,task_2735,279,288,9,279,589,0.01
2736,task_2736,31,45,14,31,552,0.007
2737,task_2737,540,550,10,539,1020,0.011
2738,task_2738,804,812,8,795,1232,0.013
2739,task_2739,1120,1128,8,1119,1203,0.013
2740,task_2740,1287,1297,10,1287,1390,0.006
2741,task_2741,761,774,13,760,1035,0.009
2742,task_2742,828,835,7,828,1022,0.013
2743,task_2743,1069,1078,9,1069,1179,0.008
2744,task_2744,685,699,14,674,1382,0.012
2745,task_2745,14,28,14,13,886,0.007
2746,task_2746,362,376,14,362,585,0.011
2747,task_2747,1221,1233,12,1221,1287,0.009
2748,task_2748,400,409,9,400,1082,0.014
2749,task_2749,681,694,13,681,720,0.007
2750,task_2750,709,720,11,709,1240,0.007
2751,task_2751,1332,1342,10,1331,1424,0.01
2752,task_2752,1158,1172,14,1156,1368,0.012
2753,task_2753,1290,1301,11,1290,1326,0.007
2754,task_2754,350,357,7,350,601,0.01
2755,task_2755,904,913,9,904,1017,0.011
2756,task_2756,1191,1200,9,1186,1329,0.014
2757,task_2757,887,901,14,884,1305,0.005
2758,task_2758,963,973,10,955,1410,0.009
2759,task_2759,743,755,12,742,1397,0.01
2760,task_2760,195,205,10,195,588,0.006
2761,task_2761,1137,1149,12,1111,1415,0.008
2762,task_2762,82,90,8,82,853,0.01
2763,task_2763,312,326,14,310,913,0.011
2764,task_2764,396,402,6,396,662,0.014
2765,task_2765,1368,1382,14,1368,1420,0.013
2766,task_2766,1087,1097,10,1087,1319,0.011
2767,task_2767,540,546,6,540,986,0.01
2768,task_2768,1343,1356,13,1343,1376,0.01
2769,task_2769,1064,1070,6,1056,1367,0.013
2770,task_2770,335,347,12,335,1062,0.008
2771,task_2771,1060,1065,5,1060,1226,0.006
2772,task_2772,1270,1282,12,1269,1379,0.008
2773,task_2773,26,38,12,26,933,0.014
2774,task_2774,401,407,6,401,705,0.013
2775,task_2775,1388,1399,11,1388,1415,0.013
2776,task_2776,714,720,6,714,835,0.011
2777,task_2777,678,685,7,678,1358,0.01
2778,task_2778,1382,1390,8,1371,1437,0.008
2779,task_2779,213,221,8,213,256,0.01
2780,task_2780,838,850,12,829,1222,0.012
2781,task_2781,1369,1380,11,1364,1424,0.012
2782,task_2782,1121,1132,11,1120,1258,0.006
2783,task_2783,1268,1279,11,1268,1331,0.008
2784,task_2784,756,762,6,756,1267,0.006
2785,task_2785,574,587,13,573,1218,0.011
2786,task_2786,265,271,6,264,1154,0.006
2787,task_2787,11,18,7,11,1320,0.005
2788,task_2788,887,896,9,884,1277,0.014
2789,task_2789,563,574,11,563,1029,0.011
2790,task_2790,1306,1313,7,1303,1368,0.013
2791,task_2791,147,154,7,147,622,0.009
2792,task_2792,1055,1064,9,1055,1209,0.011
2793,task_2793,218,226,8,218,617,0.013
2794,task_2794,1141,1150,9,1141,1232,0.011
2795,task_2795,120,130,10,120,1070,0.008
2796,task_2796,168,174,6,166,1096,0.011
2797,task_2797,274,280,6,274,1024,0.008
2798,task_2798,1086,1095,9,1083,1294,0.009
2799,task_2799,1143,1149,6,1143,1303,0.007
2800,task_2800,804,810,6,800,1222,0.006
2801,task_2801,502,513,11,502,1035,0.01
2802,task_2802,1127,1134,7,1127,1277,0.01
2803,task_2803,441,450,9,441,872,0.014
2804,task_2804,24,34,10,23,853,0.013
2805,task_2805,63,72,9,63,548,0.005
2806,task_2806,1081,1094,13,1081,1313,0.008
2807,task_2807,957,964,7,957,1110,0.007
2808,task_2808,306,318,12,297,1227,0.013
2809,task_2809,222,236,14,222,1168,0.007
2810,task_2810,1162,1170,8,1162,1273,0.008
2811,task_2811,1158,1169,11,1157,1344,0.014
2812,task_2812,917,924,7,916,1391,0.013
2813,task_2813,4,16,12,4,842,0.008
2814,task_2814,1238,1250,12,1238,1407,0.013
2815,task_2815,598,603,5,598,675,0.005
2816,task_2816,514,519,5,514,530,0.005
2817,task_2817,840,846,6,831,1308,0.007
2818,task_2818,437,442,5,437,1129,0.008
2819,task_2819,1142,1148,6,1142,1318,0.01
2820,task_2820,87,93,6,85,741,0.013
2821,task_2821,474,483,9,474,728,0.013
2822,task_2822,1176,1183,7,1176,1204,0.013
2823,task_2823,116,127,11,116,299,0.013
2824,task_2824,334,344,10,334,865,0.012
2825,task_2825,676,686,10,676,1247,0.012
2826,task_2826,1317,1331,14,1317,1350,0.006
2827,task_2827,866,878,12,865,1190,0.014
2828,task_2828,504,515,11,504,1051,0.013
2829,task_2829,688,694,6,688,1236,0.01
2830,task_2830,273,283,10,273,1176,0.008
2831,task_2831,1254,1268,14,1254,1381,0.012
2832,task_2832,213,218,5,213,988,0.013
2833,task_2833,1029,1036,7,1029,1050,0.012
2834,task_2834,780,793,13,780,1035,0.01
2835,task_2835,241,252,11,241,1340,0.013
2836,task_2836,610,616,6,610,926,0.011
2837,task_2837,618,626,8,617,1193,0.008
2838,task_2838,214,219,5,213,1153,0.008
2839,task_2839,113,126,13,113,1160,0.014
2840,task_2840,683,695,12,682,1215,0.01
2841,task_2841,339,345,6,339,1340,0.005
2842,task_2842,1369,1383,14,1369,1424,0.008
2843,task_2843,891,903,12,887,1345,0.01
2844,task_2844,1124,1135,11,1124,1164,0.01
2845,task_2845,283,288,5,282,1260,0.007
2846,task_2846,857,862,5,854,1327,0.006
2847,task_2847,1004,1013,9,1004,1043,0.006
2848,task_2848,1390,1402,12,1389,1437,0.009
2849,task_2849,95,105,10,95,416,0.01
2850,task_2850,1318,1326,8,1315,1407,0.014
2851,task_2851,241,253,12,241,1105,0.006
2852,task_2852,1103,1109,6,1102,1261,0.007
2853,task_2853,411,420,9,411,1385,0.012
2854,task_2854,1055,1067,12,1030,1382,0.012
2855,task_2855,812,817,5,812,1151,0.011
2856,task_2856,394,407,13,394,596,0.011
2857,task_2857,177,189,12,177,435,0.012
2858,task_2858,314,326,12,314,1140,0.012
2859,task_2859,531,541,10,531,777,0.006
2860,task_2860,537,543,6,537,1174,0.012
2861,task_2861,7,18,11,7,579,0.007
2862,task_2862,127,139,12,127,1387,0.014
2863,task_2863,1211,1222,11,1211,1377,0.009
2864,task_2864,212,223,11,211,928,0.013
2865,task_2865,1367,1375,8,1366,1417,0.005
2866,task_2866,1064,1074,10,1064,1261,0.006
2867,task_2867,762,769,7,762,1255,0.008
2868,task_2868,1019,1029,10,1019,1073,0.008
2869,task_2869,167,179,12,165,768,0.008
2870,task_2870,1011,1019,8,1011,1402,0.009
2871,task_2871,1066,1080,14,1066,1235,0.009
2872,task_2872,225,234,9,222,1252,0.008
2873,task_2873,55,64,9,55,585,0.006
2874,task_2874,156,168,12,156,600,0.005
2875,task_2875,1244,1254,10,1244,1333,0.014
2876,task_2876,458,466,8,458,906,0.014
2877,task_2877,694,705,11,693,1174,0.014
2878,task_2878,606,616,10,606,982,0.008
2879,task_2879,1336,1349,13,1333,1408,0.009
2880,task_2880,647,654,7,647,1023,0.005
2881,task_2881,969,978,9,969,1214,0.014
2882,task_2882,865,875,10,864,1053,0.012
2883,task_2883,333,340,7,333,1309,0.012
2884,task_2884,547,558,11,547,946,0.009
2885,task_2885,386,391,5,370,1417,0.005
2886,task_2886,656,665,9,652,1241,0.005
2887,task_2887,530,537,7,484,1332,0.012
2888,task_2888,917,925,8,904,1398,0.007
2889,task_2889,594,608,14,594,1237,0.006
2890,task_2890,1218,1224,6,972,1427,0.007
2891,task_2891,31,40,9,31,366,0.007
2892,task_2892,1198,1211,13,1198,1292,0.005
2893,task_2893,421,435,14,421,558,0.009
2894,task_2894,512,526,14,511,609,0.013
2895,task_2895,1294,1299,5,1294,1325,0.007
2896,task_2896,472,480,8,472,1095,0.014
2897,task_2897,87,96,9,86,1167,0.011
2898,task_2898,560,571,11,560,970,0.01
2899,task_2899,99,108,9,99,903,0.007
2900,task_2900,625,633,8,625,774,0.007
2901,task_2901,534,547,13,534,1160,0.008
2902,task_2902,296,301,5,296,353,0.01
2903,task_2903,6,13,7,6,945,0.009
2904,task_2904,912,925,13,911,1089,0.008
2905,task_2905,1344,1350,6,1335,1431,0.012
2906,task_2906,110,116,6,110,367,0.014
2907,task_2907,1063,1073,10,1063,1296,0.009
2908,task_2908,484,496,12,483,1045,0.011
2909,task_2909,1273,1287,14,1264,1407,0.01
2910,task_2910,713,718,5,702,1310,0.007
2911,task_2911,1168,1181,13,1168,1201,0.012
2912,task_2912,1157,1162,5,1154,1335,0.008
2913,task_2913,1076,1090,14,991,1431,0.014
2914,task_2914,912,924,12,912,1104,0.011
2915,task_2915,1098,1111,13,1098,1145,0.012
2916,task_2916,906,914,8,906,1279,0.006
2917,task_2917,1097,1105,8,1097,1325,0.009
2918,task_2918,892,904,12,892,943,0.007
2919,task_2919,690,701,11,690,802,0.011
2920,task_2920,1228,1236,8,1228,1331,0.009
2921,task_2921,512,518,6,511,755,0.01
2922,task_2922,625,632,7,625,853,0.012
2923,task_2923,826,833,7,826,887,0.01
2924,task_2924,1120,1133,13,1120,1252,0.01
2925,task_2925,1248,1256,8,1248,1274,0.006
2926,task_2926,1293,1306,13,1293,1385,0.01
2927,task_2927,1056,1064,8,1056,1102,0.007
2928,task_2928,1163,1177,14,1163,1265,0.007
2929,task_2929,1248,1255,7,1248,1340,0.009
2930,task_2930,1092,1100,8,1090,1294,0.006
2931,task_2931,204,209,5,202,982,0.013
2932,task_2932,1381,1390,9,1378,1436,0.009
2933,task_2933,1348,1356,8,1348,1401,0.006
2934,task_2934,208,214,6,208,845,0.009
2935,task_2935,746,759,13,746,1083,0.011
2936,task_2936,334,340,6,334,473,0.01
2937,task_2937,1262,1268,6,1260,1374,0.007
2938,task_2938,373,378,5,367,1359,0.005
2939,task_2939,749,754,5,749,1064,0.008
2940,task_2940,312,324,12,311,1322,0.009
2941,task_2941,271,285,14,269,1149,0.008
2942,task_2942,912,921,9,911,1378,0.01
2943,task_2943,988,999,11,988,1030,0.008
2944,task_2944,187,199,12,187,1162,0.006
2945,task_2945,40,51,11,40,1344,0.005
2946,task_2946,583,591,8,583,978,0.012
2947,task_2947,534,546,12,534,1130,0.006
2948,task_2948,54,59,5,54,1161,0.005
2949,task_2949,388,393,5,388,535,0.014
2950,task_2950,529,543,14,528,1150,0.008
2951,task_2951,1218,1228,10,1218,1298,0.005
2952,task_2952,785,794,9,785,865,0.006
2953,task_2953,1345,1352,7,1345,1382,0.014
2954,task_2954,307,316,9,296,1260,0.006
2955,task_2955,885,893,8,885,922,0.005
2956,task_2956,1319,1325,6,1315,1420,0.012
2957,task_2957,615,628,13,615,846,0.014
2958,task_2958,1175,1184,9,1172,1364,0.005
2959,task_2959,391,400,9,391,413,0.013
2960,task_2960,543,549,6,542,869,0.007
2961,task_2961,163,177,14,162,1173,0.009
2962,task_2962,494,500,6,494,567,0.013
2963,task_2963,308,314,6,308,949,0.01
2964,task_2964,890,903,13,890,1283,0.011
2965,task_2965,907,912,5,897,1331,0.008
2966,task_2966,942,952,10,940,1283,0.01
2967,task_2967,176,187,11,176,585,0.012
2968,task_2968,1075,1080,5,1075,1379,0.005
2969,task_2969,750,758,8,750,916,0.007
2970,task_2970,762,774,12,761,1397,0.008
2971,task_2971,1390,1396,6,1390,1434,0.012
2972,task_2972,1152,1165,13,1152,1175,0.011
2973,task_2973,1278,1286,8,1278,1315,0.007
2974,task_2974,600,605,5,600,1320,0.009
2975,task_2975,828,838,10,828,871,0.012
2976,task_2976,287,300,13,287,1262,0.011
2977,task_2977,1306,1318,12,1304,1381,0.012
2978,task_2978,1166,1180,14,1166,1320,0.005
2979,task_2979,469,482,13,469,746,0.005
2980,task_2980,323,328,5,323,428,0.012
2981,task_2981,273,278,5,273,1305,0.005
2982,task_2982,566,573,7,566,933,0.011
2983,task_2983,1164,1175,11,1164,1335,0.005
2984,task_2984,586,598,12,585,1011,0.008
2985,task_2985,52,63,11,52,170,0.005
2986,task_2986,480,489,9,480,835,0.009
2987,task_2987,964,972,8,964,1022,0.014
2988,task_2988,144,158,14,144,380,0.012
2989,task_2989,1005,1014,9,1002,1303,0.011
2990,task_2990,987,1001,14,987,1257,0.01
2991,task_2991,1144,1151,7,1144,1203,0.006
2992,task_2992,1046,1055,9,1046,1304,0.012
2993,task_2993,72,84,12,72,419,0.008
2994,task_2994,1122,1128,6,1120,1399,0.006
2995,task_2995,1113,1127,14,1113,1267,0.009
2996,task_2996,1311,1318,7,1311,1349,0.005
2997,task_2997,634,641,7,634,1348,0.005
2998,task_2998,938,946,8,931,1285,0.012
2999,task_2999,373,380,7,369,1331,0.007
3000,task_3000,1,8,7,1,767,0.014
3001,task_3001,314,323,9,314,727,0.014
3002,task_3002,891,904,13,891,1255,0.009
3003,task_3003,581,594,13,581,720,0.01
3004,task_3004,70,83,13,70,395,0.012
3005,task_3005,267,275,8,267,1277,0.012
3006,task_3006,772,785,13,772,896,0.012
3007,task_3007,1145,1152,7,1145,1258,0.005
3008,task_3008,1387,1393,6,1387,1433,0.014
3009,task_3009,814,822,8,794,1316,0.012
3010,task_3010,67,72,5,67,118,0.008
3011,task_3011,786,794,8,784,1137,0.009
3012,task_3012,1166,1172,6,1166,1322,0.006
3013,task_3013,513,524,11,512,1166,0.005
3014,task_3014,616,622,6,616,1137,0.011
3015,task_3015,164,169,5,164,1413,0.008
3016,task_3016,926,937,11,876,1408,0.01
3017,task_3017,189,202,13,189,593,0.009
3018,task_3018,1114,1127,13,1114,1197,0.006
3019,task_3019,281,291,10,281,616,0.01
3020,task_3020,188,201,13,188,484,0.01
3021,task_3021,1200,1207,7,1198,1376,0.01
3022,task_3022,486,494,8,485,1021,0.012
3023,task_3023,1317,1329,12,1317,1387,0.009
3024,task_3024,515,525,10,515,1036,0.006
3025,task_3025,1308,1313,5,1306,1402,0.006
3026,task_3026,1325,1335,10,1324,1419,0.01
3027,task_3027,1201,1213,12,1201,1398,0.013
3028,task_3028,971,976,5,971,1219,0.012
3029,task_3029,537,543,6,535,1155,0.014
3030,task_3030,1234,1244,10,1234,1298,0.011
3031,task_3031,546,557,11,546,645,0.005
3032,task_3032,568,582,14,568,1180,0.013
3033,task_3033,84,98,14,84,462,0.005
3034,task_3034,586,591,5,586,1109,0.008
3035,task_3035,153,160,7,152,986,0.013
3036,task_3036,575,584,9,573,1306,0.013
3037,task_3037,1379,1384,5,1379,1405,0.011
3038,task_3038,1254,1259,5,1254,1295,0.011
3039,task_3039,801,812,11,801,826,0.009
3040,task_3040,342,352,10,342,579,0.009
3041,task_3041,86,92,6,86,308,0.01
3042,task_3042,1369,1381,12,1369,1420,0.005
3043,task_3043,582,595,13,582,1185,0.013
3044,task_3044,715,726,11,715,751,0.008
3045,task_3045,1301,1315,14,1301,1381,0.013
3046,task_3046,257,271,14,257,1421,0.009
3047,task_3047,897,904,7,896,1048,0.008
3048,task_3048,680,694,14,680,831,0.007
3049,task_3049,4,11,7,4,1093,0.011
3050,task_3050,1387,1394,7,1387,1427,0.013
3051,task_3051,1230,1243,13,1230,1301,0.012
3052,task_3052,571,584,13,570,1186,0.005
3053,task_3053,964,973,9,964,1086,0.008
3054,task_3054,44,50,6,44,893,0.012
3055,task_3055,586,594,8,586,1103,0.007
3056,task_3056,643,648,5,643,688,0.011
3057,task_3057,613,622,9,613,1034,0.005
3058,task_3058,265,275,10,265,687,0.012
3059,task_3059,527,540,13,521,1325,0.005
3060,task_3060,311,317,6,311,625,0.01
3061,task_3061,1128,1136,8,1128,1233,0.013
3062,task_3062,578,584,6,578,1158,0.007
3063,task_3063,126,133,7,124,1384,0.005
3064,task_3064,165,177,12,165,610,0.011
3065,task_3065,757,763,6,757,1324,0.008
3066,task_3066,989,1001,12,989,1045,0.012
3067,task_3067,605,615,10,569,1430,0.012
3068,task_3068,738,750,12,738,801,0.008
3069,task_3069,331,339,8,331,932,0.005
3070,task_3070,631,640,9,631,1220,0.009
3071,task_3071,1131,1143,12,1131,1219,0.008
3072,task_3072,1223,1233,10,1223,1260,0.014
3073,task_3073,287,293,6,287,681,0.009
3074,task_3074,522,534,12,522,768,0.008
3075,task_3075,887,895,8,879,1288,0.011
3076,task_3076,169,175,6,169,518,0.008
3077,task_3077,761,775,14,761,1152,0.013
3078,task_3078,1208,1221,13,1197,1423,0.009
3079,task_3079,1073,1079,6,1071,1342,0.012
3080,task_3080,541,548,7,538,1347,0.013
3081,task_3081,860,870,10,860,1175,0.01
3082,task_3082,972,979,7,972,1188,0.006
3083,task_3083,613,621,8,613,950,0.006
3084,task_3084,802,815,13,802,1004,0.013
3085,task_3085,320,333,13,320,638,0.007
3086,task_3086,164,173,9,164,472,0.005
3087,task_3087,528,541,13,528,596,0.008
3088,task_3088,1024,1034,10,1024,1175,0.01
3089,task_3089,1328,1339,11,1328,1404,0.013
3090,task_3090,632,641,9,632,1005,0.014
3091,task_3091,376,387,11,376,564,0.013
3092,task_3092,107,115,8,107,779,0.01
3093,task_3093,130,137,7,130,318,0.01
3094,task_3094,1293,1306,13,1270,1420,0.012
3095,task_3095,16,23,7,16,161,0.005
3096,task_3096,189,194,5,189,1157,0.008
3097,task_3097,600,607,7,600,1216,0.008
3098,task_3098,356,365,9,354,1117,0.007
3099,task_3099,1128,1139,11,1128,1272,0.009
3100,task_3100,1291,1303,12,1291,1370,0.005
3101,task_3101,1338,1349,11,1334,1414,0.014
3102,task_3102,475,482,7,475,981,0.012
3103,task_3103,308,319,11,308,995,0.006
3104,task_3104,265,279,14,265,1207,0.007
3105,task_3105,1238,1249,11,1238,1260,0.009
3106,task_3106,535,540,5,535,634,0.01
3107,task_3107,872,880,8,872,931,0.009
3108,task_3108,1230,1235,5,1230,1280,0.014
3109,task_3109,411,417,6,411,1383,0.007
3110,task_3110,64,73,9,64,126,0.012
3111,task_3111,311,317,6,311,544,0.006
3112,task_3112,909,914,5,909,1034,0.009
3113,task_3113,426,434,8,426,1337,0.012
3114,task_3114,551,564,13,551,893,0.009
3115,task_3115,725,731,6,725,1117,0.007
3116,task_3116,327,334,7,327,898,0.007
3117,task_3117,1277,1284,7,1277,1353,0.012
3118,task_3118,1122,1131,9,1077,1406,0.01
3119,task_3119,515,523,8,484,1283,0.008
3120,task_3120,46,51,5,46,274,0.009
3121,task_3121,975,983,8,975,1333,0.005
3122,task_3122,828,838,10,828,1020,0.01
3123,task_3123,1011,1016,5,1008,1326,0.009
3124,task_3124,477,485,8,477,581,0.006
3125,task_3125,1124,1136,12,1124,1368,0.013
3126,task_3126,252,257,5,252,393,0.005
3127,task_3127,1103,1113,10,1102,1243,0.008
3128,task_3128,1170,1181,11,1169,1300,0.009
3129,task_3129,771,780,9,771,1394,0.007
3130,task_3130,408,418,10,408,739,0.013
3131,task_3131,691,698,7,691,724,0.014
3132,task_3132,153,158,5,153,216,0.01
3133,task_3133,625,630,5,625,1220,0.014
3134,task_3134,1074,1086,12,1049,1423,0.014
3135,task_3135,418,425,7,418,661,0.011
3136,task_3136,91,105,14,90,997,0.007
3137,task_3137,148,153,5,143,1205,0.013
3138,task_3138,169,183,14,169,612,0.005
3139,task_3139,617,629,12,617,685,0.012
3140,task_3140,1358,1364,6,573,1437,0.007
3141,task_3141,1027,1034,7,1027,1169,0.013
3142,task_3142,357,367,10,353,1226,0.005
3143,task_3143,1341,1354,13,1340,1403,0.006
3144,task_3144,614,627,13,614,1138,0.01
3145,task_3145,992,1004,12,992,1222,0.009
3146,task_3146,55,66,11,55,808,0.006
3147,task_3147,493,507,14,493,1083,0.011
3148,task_3148,552,563,11,552,897,0.014
3149,task_3149,67,72,5,67,1127,0.013
3150,task_3150,291,296,5,291,1068,0.014
3151,task_3151,1171,1180,9,1171,1273,0.009
3152,task_3152,1008,1014,6,1008,1058,0.011
3153,task_3153,588,600,12,527,1403,0.013
3154,task_3154,1348,1359,11,1348,1373,0.005
3155,task_3155,745,754,9,745,1196,0.012
3156,task_3156,200,214,14,200,406,0.006
3157,task_3157,133,138,5,133,632,0.014
3158,task_3158,161,170,9,161,570,0.006
3159,task_3159,842,853,11,842,1143,0.012
3160,task_3160,1019,1031,12,1019,1285,0.006
3161,task_3161,685,699,14,647,1390,0.013
3162,task_3162,1004,1017,13,1003,1290,0.005
3163,task_3163,529,540,11,528,1101,0.013
3164,task_3164,1110,1115,5,1108,1296,0.01
3165,task_3165,591,600,9,590,1052,0.009
3166,task_3166,860,873,13,860,1069,0.013
3167,task_3167,1396,1408,12,1396,1432,0.012
3168,task_3168,211,222,11,211,407,0.009
3169,task_3169,25,34,9,16,1371,0.009
3170,task_3170,162,175,13,162,492,0.012
3171,task_3171,1391,1403,12,1391,1418,0.01
3172,task_3172,979,990,11,979,1385,0.007
3173,task_3173,471,479,8,471,1310,0.011
3174,task_3174,210,216,6,210,634,0.014
3175,task_3175,1055,1062,7,1055,1073,0.013
3176,task_3176,1204,1212,8,1190,1406,0.012
3177,task_3177,225,230,5,225,815,0.009
3178,task_3178,422,434,12,422,1113,0.012
3179,task_3179,1282,1293,11,1282,1324,0.012
3180,task_3180,217,228,11,217,879,0.012
3181,task_3181,637,651,14,637,835,0.013
3182,task_3182,1361,1371,10,1359,1424,0.014
3183,task_3183,1121,1131,10,1119,1366,0.007
3184,task_3184,160,167,7,160,1094,0.013
3185,task_3185,1187,1197,10,1187,1243,0.012
3186,task_3186,1266,1280,14,1265,1379,0.014
3187,task_3187,400,411,11,398,1197,0.012
3188,task_3188,663,671,8,662,988,0.013
3189,task_3189,411,417,6,411,1026,0.006
3190,task_3190,379,393,14,352,1397,0.007
3191,task_3191,46,53,7,46,749,0.013
3192,task_3192,1154,1162,8,1154,1324,0.006
3193,task_3193,621,631,10,619,955,0.012
3194,task_3194,1214,1224,10,1214,1356,0.008
3195,task_3195,1202,1210,8,1202,1257,0.009
3196,task_3196,1302,1313,11,1302,1380,0.005
3197,task_3197,1227,1234,7,1227,1360,0.01
3198,task_3198,997,1003,6,997,1149,0.005
3199,task_3199,1154,1166,12,1154,1280,0.014
3200,task_3200,285,296,11,285,1310,0.011
3201,task_3201,554,566,12,554,905,0.006
3202,task_3202,13,20,7,13,631,0.005
3203,task_3203,115,121,6,114,1100,0.01
3204,task_3204,150,162,12,150,387,0.007
3205,task_3205,270,283,13,270,376,0.009
3206,task_3206,1020,1030,10,1019,1333,0.008
3207,task_3207,367,377,10,361,1237,0.006
3208,task_3208,1105,1112,7,1104,1319,0.011
3209,task_3209,795,802,7,795,1006,0.014
3210,task_3210,1094,1100,6,1094,1215,0.013
3211,task_3211,698,712,14,698,1133,0.005
3212,task_3212,104,113,9,103,754,0.013
3213,task_3213,1320,1329,9,1320,1367,0.008
3214,task_3214,725,735,10,725,955,0.007
3215,task_3215,627,636,9,626,1085,0.014
3216,task_3216,65,74,9,65,590,0.005
3217,task_3217,421,427,6,421,913,0.008
3218,task_3218,576,589,13,576,1003,0.008
3219,task_3219,804,814,10,794,1231,0.008
3220,task_3220,688,700,12,688,1110,0.006
3221,task_3221,584,598,14,506,1402,0.014
3222,task_3222,213,222,9,210,1077,0.005
3223,task_3223,0,7,7,0,176,0.008
3224,task_3224,1213,1219,6,1026,1426,0.014
3225,task_3225,863,870,7,863,1236,0.011
3226,task_3226,512,525,13,511,1008,0.014
3227,task_3227,1251,1262,11,1251,1330,0.014
3228,task_3228,28,36,8,28,459,0.013
3229,task_3229,1116,1129,13,1115,1278,0.008
3230,task_3230,1188,1195,7,1186,1312,0.014
3231,task_3231,1145,1156,11,1145,1279,0.007
3232,task_3232,606,615,9,606,848,0.011
3233,task_3233,1151,1158,7,1147,1414,0.006
3234,task_3234,106,111,5,106,763,0.009
3235,task_3235,501,509,8,501,631,0.007
3236,task_3236,897,907,10,896,1074,0.007
3237,task_3237,1399,1411,12,1398,1436,0.009
3238,task_3238,149,155,6,149,1194,0.007
3239,task_3239,330,337,7,330,1417,0.011
3240,task_3240,1361,1368,7,1361,1416,0.012
3241,task_3241,337,347,10,337,480,0.006
3242,task_3242,48,59,11,48,868,0.009
3243,task_3243,1262,1267,5,1261,1434,0.009
3244,task_3244,84,91,7,84,1100,0.005
3245,task_3245,728,734,6,724,1399,0.01
3246,task_3246,818,825,7,818,1095,0.006
3247,task_3247,664,676,12,652,1311,0.011
3248,task_3248,339,346,7,339,1035,0.007
3249,task_3249,78,84,6,78,895,0.006
3250,task_3250,1162,1174,12,1162,1205,0.007
3251,task_3251,901,915,14,901,951,0.01
3252,task_3252,230,242,12,230,616,0.011
3253,task_3253,1206,1215,9,1205,1340,0.006
3254,task_3254,456,467,11,456,1322,0.013
3255,task_3255,739,746,7,739,1125,0.01
3256,task_3256,982,992,10,982,1243,0.005
3257,task_3257,541,549,8,541,792,0.008
3258,task_3258,978,985,7,978,1052,0.013
3259,task_3259,97,105,8,97,367,0.01
3260,task_3260,207,220,13,207,1096,0.008
3261,task_3261,1039,1053,14,1027,1370,0.009
3262,task_3262,171,183,12,171,1180,0.01
3263,task_3263,720,730,10,720,850,0.01
3264,task_3264,663,668,5,663,901,0.005
3265,task_3265,703,709,6,703,1031,0.01
3266,task_3266,1143,1152,9,1143,1191,0.007
3267,task_3267,89,101,12,81,1262,0.013
3268,task_3268,141,155,14,141,257,0.005
3269,task_3269,925,933,8,881,1399,0.014
3270,task_3270,187,200,13,187,533,0.011
3271,task_3271,1130,1140,10,1127,1348,0.014
3272,task_3272,89,95,6,86,1263,0.008
3273,task_3273,246,253,7,246,551,0.009
3274,task_3274,868,878,10,868,911,0.013
3275,task_3275,124,135,11,124,497,0.011
3276,task_3276,217,224,7,217,1210,0.014
3277,task_3277,1226,1240,14,1226,1337,0.009
3278,task_3278,406,415,9,406,736,0.007
3279,task_3279,14,26,12,14,929,0.008
3280,task_3280,636,648,12,636,802,0.007
3281,task_3281,303,311,8,303,549,0.01
3282,task_3282,1241,1254,13,1241,1295,0.008
3283,task_3283,416,423,7,415,1378,0.007
3284,task_3284,1224,1238,14,1224,1434,0.005
3285,task_3285,1363,1368,5,1363,1380,0.005
3286,task_3286,1308,1313,5,1303,1409,0.011
3287,task_3287,379,387,8,366,1391,0.01
3288,task_3288,928,933,5,928,1048,0.008
3289,task_3289,951,956,5,949,1319,0.006
3290,task_3290,1295,1300,5,1294,1409,0.009
3291,task_3291,83,89,6,83,768,0.01
3292,task_3292,580,593,13,570,1371,0.011
3293,task_3293,103,114,11,103,222,0.009
3294,task_3294,974,984,10,974,1386,0.007
3295,task_3295,1067,1073,6,1067,1335,0.008
3296,task_3296,979,984,5,979,1104,0.006
3297,task_3297,508,516,8,497,1273,0.008
3298,task_3298,811,823,12,811,887,0.01
3299,task_3299,1372,1382,10,1372,1398,0.01
3300,task_3300,621,632,11,611,1336,0.012
3301,task_3301,1343,1348,5,1343,1377,0.01
3302,task_3302,333,338,5,333,944,0.006
3303,task_3303,1197,1204,7,1197,1335,0.013
3304,task_3304,485,493,8,485,545,0.012
3305,task_3305,994,1005,11,994,1145,0.011
3306,task_3306,470,484,14,470,943,0.012
3307,task_3307,1384,1391,7,1384,1415,0.013
3308,task_3308,563,573,10,561,1169,0.013
3309,task_3309,933,943,10,932,1105,0.008
3310,task_3310,375,385,10,374,874,0.009
3311,task_3311,60,69,9,60,397,0.008
3312,task_3312,288,299,11,288,634,0.01
3313,task_3313,378,389,11,378,1293,0.012
3314,task_3314,638,644,6,638,869,0.005
3315,task_3315,1316,1326,10,1316,1348,0.006
3316,task_3316,664,670,6,663,1183,0.007
3317,task_3317,43,49,6,43,829,0.011
3318,task_3318,361,367,6,361,986,0.007
3319,task_3319,221,229,8,221,1008,0.014
3320,task_3320,178,183,5,178,221,0.008
3321,task_3321,899,907,8,897,1217,0.008
3322,task_3322,1284,1290,6,1281,1338,0.005
3323,task_3323,1180,1189,9,1120,1426,0.011
3324,task_3324,1222,1230,8,1221,1421,0.009
3325,task_3325,894,904,10,894,1045,0.014
3326,task_3326,587,601,14,587,1158,0.007
3327,task_3327,36,45,9,36,700,0.014
3328,task_3328,395,404,9,395,629,0.008
3329,task_3329,371,379,8,371,651,0.011
3330,task_3330,412,421,9,412,474,0.013
3331,task_3331,965,975,10,965,1404,0.013
3332,task_3332,419,427,8,419,1018,0.007
3333,task_3333,30,41,11,30,230,0.005
3334,task_3334,862,867,5,862,984,0.011
3335,task_3335,983,991,8,983,1095,0.006
3336,task_3336,277,284,7,277,354,0.006
3337,task_3337,86,96,10,86,177,0.011
3338,task_3338,1007,1015,8,1002,1401,0.006
3339,task_3339,826,834,8,826,1157,0.005
3340,task_3340,1273,1283,10,1273,1391,0.005
3341,task_3341,359,365,6,359,738,0.014
3342,task_3342,1256,1265,9,1256,1324,0.005
3343,task_3343,214,219,5,212,1190,0.009
3344,task_3344,93,105,12,81,1389,0.011
3345,task_3345,1288,1294,6,1288,1368,0.006
3346,task_3346,1162,1174,12,1162,1314,0.013
3347,task_3347,1132,1138,6,1132,1385,0.013
3348,task_3348,461,475,14,461,776,0.008
3349,task_3349,74,80,6,74,1146,0.013
3350,task_3350,204,215,11,202,1127,0.006
3351,task_3351,590,604,14,590,898,0.01
3352,task_3352,939,947,8,930,1290,0.013
3353,task_3353,276,287,11,276,409,0.012
3354,task_3354,1221,1226,5,1221,1311,0.006
3355,task_3355,942,956,14,942,1012,0.005
3356,task_3356,0,8,8,0,57,0.007
3357,task_3357,805,818,13,805,1204,0.01
3358,task_3358,1118,1129,11,1118,1193,0.008
3359,task_3359,1262,1271,9,1256,1397,0.007
3360,task_3360,469,476,7,469,600,0.013
3361,task_3361,507,514,7,507,1142,0.007
3362,task_3362,1198,1203,5,1198,1330,0.01
3363,task_3363,727,737,10,727,960,0.007
3364,task_3364,853,861,8,853,933,0.014
3365,task_3365,445,451,6,445,1375,0.012
3366,task_3366,850,863,13,850,1297,0.013
3367,task_3367,1202,1210,8,1202,1299,0.013
3368,task_3368,1166,1175,9,1158,1403,0.01
3369,task_3369,16,24,8,16,580,0.013
3370,task_3370,593,600,7,543,1410,0.008
3371,task_3371,1314,1320,6,1312,1392,0.01
3372,task_3372,786,792,6,786,906,0.005
3373,task_3373,483,492,9,483,990,0.011
3374,task_3374,524,536,12,524,709,0.014
3375,task_3375,916,926,10,909,1392,0.005
3376,task_3376,1111,1122,11,1110,1347,0.011
3377,task_3377,1118,1128,10,1118,1376,0.009
3378,task_3378,791,796,5,791,874,0.013
3379,task_3379,586,592,6,585,832,0.008
3380,task_3380,737,746,9,737,800,0.013
3381,task_3381,1388,1394,6,1385,1438,0.014
3382,task_3382,1135,1148,13,1135,1305,0.007
3383,task_3383,818,828,10,818,1093,0.014
3384,task_3384,938,946,8,938,1157,0.007
3385,task_3385,136,147,11,136,212,0.007
3386,task_3386,15,25,10,15,391,0.007
3387,task_3387,324,332,8,324,941,0.007
3388,task_3388,961,966,5,961,1332,0.014
3389,task_3389,271,278,7,269,1151,0.009
3390,task_3390,218,223,5,218,1062,0.006
3391,task_3391,1012,1017,5,1012,1117,0.006
3392,task_3392,224,236,12,221,1238,0.007
3393,task_3393,690,697,7,689,743,0.007
3394,task_3394,1211,1225,14,1211,1245,0.01
3395,task_3395,892,899,7,892,1133,0.008
3396,task_3396,912,925,13,912,1135,0.014
3397,task_3397,677,683,6,677,1126,0.013
3398,task_3398,1059,1066,7,1059,1212,0.013
3399,task_3399,633,638,5,633,872,0.012
3400,task_3400,522,530,8,521,1280,0.009
3401,task_3401,191,204,13,191,454,0.013
3402,task_3402,668,676,8,667,1297,0.007
3403,task_3403,428,437,9,428,815,0.006
3404,task_3404,1221,1232,11,1221,1299,0.011
3405,task_3405,1080,1091,11,1078,1371,0.01
3406,task_3406,1381,1387,6,1374,1431,0.006
3407,task_3407,776,782,6,776,814,0.007
3408,task_3408,1277,1289,12,1277,1329,0.008
3409,task_3409,622,627,5,622,833,0.011
3410,task_3410,1351,1357,6,1351,1367,0.011
3411,task_3411,200,212,12,200,559,0.013
3412,task_3412,266,275,9,265,1251,0.012
3413,task_3413,1005,1015,10,1002,1367,0.01
3414,task_3414,819,826,7,806,1357,0.01
3415,task_3415,1399,1411,12,1396,1436,0.007
3416,task_3416,234,247,13,223,1427,0.009
3417,task_3417,1351,1357,6,1351,1379,0.011
3418,task_3418,627,638,11,627,1002,0.012
3419,task_3419,1050,1064,14,1049,1149,0.007
3420,task_3420,1185,1196,11,1185,1245,0.005
3421,task_3421,1329,1336,7,1281,1429,0.008
3422,task_3422,585,597,12,585,652,0.01
3423,task_3423,1181,1187,6,1181,1235,0.006
3424,task_3424,916,926,10,916,1089,0.009
3425,task_3425,580,588,8,580,685,0.006
3426,task_3426,380,391,11,380,622,0.006
3427,task_3427,501,515,14,496,1166,0.014
3428,task_3428,525,533,8,524,778,0.007
3429,task_3429,307,314,7,292,1340,0.006
3430,task_3430,1335,1344,9,1335,1386,0.014
3431,task_3431,1286,1300,14,1283,1356,0.005
3432,task_3432,654,664,10,654,975,0.007
3433,task_3433,148,155,7,147,1154,0.011
3434,task_3434,241,248,7,241,751,0.01
3435,task_3435,1192,1200,8,1192,1316,0.005
3436,task_3436,550,559,9,549,998,0.012
3437,task_3437,1171,1179,8,1171,1299,0.013
3438,task_3438,1103,1110,7,1103,1287,0.012
3439,task_3439,35,48,13,35,1297,0.014
3440,task_3440,1060,1070,10,1059,1325,0.006
3441,task_3441,271,283,12,271,1274,0.006
3442,task_3442,1220,1225,5,1220,1277,0.005
3443,task_3443,487,500,13,485,1146,0.012
3444,task_3444,1367,1378,11,1367,1406,0.014
3445,task_3445,816,826,10,791,1342,0.012
3446,task_3446,1098,1112,14,1098,1222,0.011
3447,task_3447,138,144,6,138,206,0.007
3448,task_3448,190,197,7,190,621,0.009
3449,task_3449,1152,1165,13,1152,1255,0.008
3450,task_3450,1295,1302,7,1294,1370,0.014
3451,task_3451,332,338,6,332,464,0.012
3452,task_3452,31,42,11,31,1048,0.014
3453,task_3453,1300,1314,14,1284,1426,0.014
3454,task_3454,544,556,12,542,1144,0.006
3455,task_3455,534,540,6,518,1363,0.009
3456,task_3456,1213,1224,11,1213,1319,0.011
3457,task_3457,646,653,7,646,1350,0.011
3458,task_3458,884,894,10,884,954,0.008
3459,task_3459,598,603,5,598,1367,0.011
3460,task_3460,306,320,14,298,1247,0.011
3461,task_3461,605,615,10,605,822,0.01
3462,task_3462,128,140,12,128,777,0.009
3463,task_3463,796,806,10,793,1023,0.008
3464,task_3464,614,625,11,614,1078,0.008
3465,task_3465,562,573,11,562,1122,0.006
3466,task_3466,354,365,11,354,620,0.007
3467,task_3467,933,947,14,931,1181,0.008
3468,task_3468,920,933,13,919,1034,0.007
3469,task_3469,68,74,6,68,1334,0.009
3470,task_3470,644,653,9,644,669,0.012
3471,task_3471,131,145,14,130,583,0.013
3472,task_3472,83,93,10,82,875,0.014
3473,task_3473,766,778,12,765,1263,0.014
3474,task_3474,453,464,11,453,795,0.012
3475,task_3475,490,502,12,488,877,0.007
3476,task_3476,24,37,13,21,700,0.013
3477,task_3477,611,620,9,611,829,0.012
3478,task_3478,1118,1132,14,1093,1410,0.008
3479,task_3479,1210,1218,8,1210,1369,0.008
3480,task_3480,1014,1025,11,1014,1292,0.007
3481,task_3481,1066,1074,8,1042,1409,0.009
3482,task_3482,567,575,8,567,1183,0.007
3483,task_3483,903,910,7,903,1192,0.011
3484,task_3484,240,246,6,240,1179,0.01
3485,task_3485,1148,1153,5,1148,1262,0.005
3486,task_3486,42,52,10,42,87,0.007
3487,task_3487,1277,1283,6,1276,1390,0.013
3488,task_3488,904,915,11,897,1269,0.01
3489,task_3489,586,591,5,586,1364,0.01
3490,task_3490,441,455,14,441,1381,0.005
3491,task_3491,923,930,7,923,1330,0.005
3492,task_3492,379,391,12,379,473,0.006
3493,task_3493,836,845,9,836,1060,0.005
3494,task_3494,1129,1140,11,1129,1331,0.012
3495,task_3495,437,450,13,437,1118,0.008
3496,task_3496,1275,1288,13,1274,1375,0.013
3497,task_3497,610,617,7,610,877,0.011
3498,task_3498,1194,1208,14,1194,1313,0.013
3499,task_3499,1222,1227,5,1221,1363,0.012
3500,task_3500,1100,1109,9,1100,1205,0.006
3501,task_3501,1266,1279,13,1266,1384,0.008
3502,task_3502,1096,1103,7,1096,1315,0.005
3503,task_3503,555,565,10,555,749,0.009
3504,task_3504,639,648,9,639,872,0.007
3505,task_3505,988,994,6,988,1160,0.006
3506,task_3506,1181,1188,7,1181,1242,0.011
3507,task_3507,699,713,14,693,1245,0.014
3508,task_3508,442,455,13,442,1225,0.006
3509,task_3509,435,442,7,435,812,0.008
3510,task_3510,105,111,6,105,669,0.011
3511,task_3511,737,745,8,737,954,0.013
3512,task_3512,340,347,7,340,1152,0.013
3513,task_3513,553,566,13,551,1027,0.011
3514,task_3514,186,193,7,186,697,0.008
3515,task_3515,948,955,7,948,1167,0.012
3516,task_3516,246,251,5,246,1327,0.009
3517,task_3517,242,251,9,242,1382,0.013
3518,task_3518,1049,1063,14,1049,1079,0.014
3519,task_3519,902,912,10,902,1046,0.007
3520,task_3520,1311,1321,10,1311,1398,0.01
3521,task_3521,746,756,10,746,1261,0.005
3522,task_3522,229,240,11,229,889,0.01
3523,task_3523,801,810,9,798,1156,0.011
3524,task_3524,1333,1344,11,1333,1359,0.007
3525,task_3525,359,372,13,359,815,0.014
3526,task_3526,850,860,10,850,1030,0.013
3527,task_3527,1210,1222,12,1210,1339,0.007
3528,task_3528,722,734,12,722,929,0.01
3529,task_3529,150,161,11,150,1250,0.011
3530,task_3530,67,75,8,67,753,0.007
3531,task_3531,1206,1214,8,1205,1402,0.01
3532,task_3532,674,679,5,674,735,0.006
3533,task_3533,755,769,14,755,1202,0.008
3534,task_3534,999,1011,12,998,1334,0.005
3535,task_3535,1081,1090,9,1077,1397,0.009
3536,task_3536,130,143,13,129,358,0.012
3537,task_3537,120,128,8,119,1162,0.012
3538,task_3538,921,926,5,921,1072,0.007
3539,task_3539,258,265,7,258,356,0.007
3540,task_3540,1165,1178,13,1165,1309,0.006
3541,task_3541,1056,1066,10,1056,1318,0.006
3542,task_3542,1278,1291,13,1278,1350,0.005
3543,task_3543,589,600,11,494,1407,0.008
3544,task_3544,1379,1385,6,1379,1427,0.008
3545,task_3545,920,934,14,920,1046,0.009
3546,task_3546,546,554,8,546,577,0.013
3547,task_3547,1035,1046,11,1033,1234,0.007
3548,task_3548,1029,1036,7,1029,1138,0.006
3549,task_3549,1055,1068,13,1055,1159,0.009
3550,task_3550,759,772,13,713,1432,0.011
3551,task_3551,222,229,7,222,414,0.01
3552,task_3552,1211,1217,6,796,1425,0.007
3553,task_3553,1349,1362,13,1349,1394,0.01
3554,task_3554,1222,1228,6,1221,1325,0.007
3555,task_3555,1165,1175,10,1165,1254,0.013
3556,task_3556,504,516,12,504,541,0.014
3557,task_3557,776,789,13,776,994,0.011
3558,task_3558,1238,1243,5,1238,1286,0.006
3559,task_3559,584,593,9,584,734,0.011
3560,task_3560,1167,1181,14,1167,1342,0.01
3561,task_3561,91,104,13,91,525,0.005
3562,task_3562,229,236,7,228,1308,0.009
3563,task_3563,749,758,9,749,886,0.012
3564,task_3564,951,961,10,951,1250,0.005
3565,task_3565,1074,1088,14,1074,1139,0.008
3566,task_3566,217,223,6,214,1243,0.006
3567,task_3567,1076,1086,10,879,1427,0.009
3568,task_3568,601,611,10,591,1423,0.009
3569,task_3569,857,865,8,857,1084,0.005
3570,task_3570,30,43,13,29,1126,0.009
3571,task_3571,951,960,9,948,1316,0.008
3572,task_3572,164,177,13,164,851,0.014
3573,task_3573,1122,1136,14,1112,1414,0.01
3574,task_3574,204,218,14,202,1204,0.009
3575,task_3575,908,922,14,908,1254,0.014
3576,task_3576,681,691,10,680,855,0.012
3577,task_3577,1254,1261,7,1253,1419,0.007
3578,task_3578,1161,1166,5,1160,1330,0.012
3579,task_3579,615,628,13,606,1182,0.007
3580,task_3580,694,704,10,694,1236,0.006
3581,task_3581,780,794,14,776,1223,0.012
3582,task_3582,1139,1153,14,1139,1194,0.005
3583,task_3583,1119,1128,9,1119,1176,0.013
3584,task_3584,554,563,9,554,662,0.01
3585,task_3585,87,95,8,86,773,0.014
3586,task_3586,1223,1233,10,1223,1286,0.008
3587,task_3587,976,988,12,976,1236,0.009
3588,task_3588,89,99,10,85,1288,0.013
3589,task_3589,113,127,14,107,1167,0.011
3590,task_3590,1065,1070,5,1053,1390,0.012
3591,task_3591,962,970,8,955,1393,0.01
3592,task_3592,714,725,11,714,1082,0.013
3593,task_3593,1401,1407,6,1295,1439,0.012
3594,task_3594,235,241,6,235,1027,0.011
3595,task_3595,490,501,11,488,1038,0.009
3596,task_3596,603,611,8,603,1142,0.013
3597,task_3597,845,856,11,845,966,0.006
3598,task_3598,424,431,7,424,515,0.006
3599,task_3599,977,983,6,977,1129,0.013
3600,task_3600,622,631,9,622,952,0.013
3601,task_3601,512,517,5,512,710,0.005
3602,task_3602,386,391,5,386,1191,0.008
3603,task_3603,563,577,14,563,748,0.011
3604,task_3604,413,418,5,413,1033,0.011
3605,task_3605,609,618,9,606,1143,0.006
3606,task_3606,12,18,6,12,173,0.005
3607,task_3607,227,236,9,227,1149,0.01
3608,task_3608,1378,1384,6,1378,1426,0.008
3609,task_3609,240,251,11,239,1358,0.011
3610,task_3610,111,122,11,110,945,0.011
3611,task_3611,1198,1212,14,1198,1234,0.005
3612,task_3612,203,217,14,203,400,0.007
3613,task_3613,987,992,5,987,1058,0.012
3614,task_3614,1151,1162,11,1144,1378,0.009
3615,task_3615,904,916,12,904,951,0.005
3616,task_3616,717,728,11,717,935,0.012
3617,task_3617,340,348,8,340,604,0.011
3618,task_3618,1207,1219,12,1188,1413,0.012
3619,task_3619,942,956,14,942,1069,0.01
3620,task_3620,785,797,12,782,1068,0.01
3621,task_3621,1210,1220,10,1210,1416,0.005
3622,task_3622,791,799,8,791,838,0.005
3623,task_3623,260,271,11,260,1382,0.005
3624,task_3624,894,908,14,881,1366,0.011
3625,task_3625,634,647,13,634,662,0.012
3626,task_3626,704,709,5,704,1095,0.014
3627,task_3627,1231,1244,13,1231,1391,0.006
3628,task_3628,1363,1376,13,1363,1407,0.005
3629,task_3629,51,62,11,51,694,0.007
3630,task_3630,576,584,8,576,1028,0.012
3631,task_3631,734,741,7,734,962,0.006
3632,task_3632,0,14,14,0,1210,0.008
3633,task_3633,632,643,11,632,997,0.01
3634,task_3634,1352,1363,11,1304,1438,0.012
3635,task_3635,1126,1131,5,1125,1221,0.01
3636,task_3636,1001,1009,8,996,1408,0.005
3637,task_3637,108,116,8,108,530,0.008
3638,task_3638,204,213,9,203,1170,0.005
3639,task_3639,118,125,7,117,380,0.011
3640,task_3640,1395,1400,5,1395,1416,0.005
3641,task_3641,985,990,5,985,1001,0.014
3642,task_3642,1373,1385,12,1373,1402,0.007
3643,task_3643,1346,1351,5,1346,1404,0.011
3644,task_3644,509,523,14,485,1280,0.005
3645,task_3645,1234,1241,7,1234,1274,0.008
3646,task_3646,429,442,13,429,1277,0.01
3647,task_3647,394,399,5,394,1065,0.011
3648,task_3648,517,530,13,517,952,0.007
3649,task_3649,678,686,8,646,1355,0.008
3650,task_3650,917,926,9,917,1352,0.006
3651,task_3651,126,135,9,121,1301,0.012
3652,task_3652,790,796,6,789,1069,0.013
3653,task_3653,515,522,7,515,857,0.012
3654,task_3654,986,999,13,912,1423,0.006
3655,task_3655,220,226,6,220,1078,0.007
3656,task_3656,111,121,10,110,995,0.007
3657,task_3657,656,670,14,654,1198,0.012
3658,task_3658,1218,1227,9,1218,1363,0.01
3659,task_3659,677,691,14,674,1339,0.014
3660,task_3660,970,975,5,970,996,0.005
3661,task_3661,1388,1399,11,1388,1433,0.008
3662,task_3662,226,231,5,226,383,0.011
3663,task_3663,461,470,9,461,1128,0.011
3664,task_3664,849,854,5,833,1351,0.005
3665,task_3665,796,804,8,796,1077,0.013
3666,task_3666,229,242,13,229,649,0.012
3667,task_3667,212,225,13,212,928,0.013
3668,task_3668,593,605,12,593,835,0.01
3669,task_3669,388,394,6,388,721,0.012
3670,task_3670,143,157,14,142,899,0.014
3671,task_3671,1110,1121,11,1109,1260,0.009
3672,task_3672,216,227,11,216,974,0.01
3673,task_3673,915,926,11,915,1271,0.01
3674,task_3674,239,245,6,238,775,0.01
3675,task_3675,522,536,14,522,1164,0.014
3676,task_3676,1356,1365,9,1356,1429,0.01
3677,task_3677,1207,1216,9,1207,1285,0.009
3678,task_3678,629,636,7,629,885,0.012
3679,task_3679,1056,1063,7,1056,1157,0.013
3680,task_3680,210,219,9,210,545,0.014
3681,task_3681,1023,1030,7,1023,1150,0.01
3682,task_3682,45,58,13,45,702,0.014
3683,task_3683,982,996,14,982,1217,0.009
3684,task_3684,1387,1399,12,1386,1426,0.013
3685,task_3685,881,889,8,879,1089,0.01
3686,task_3686,363,372,9,358,1220,0.008
3687,task_3687,657,669,12,657,686,0.013
3688,task_3688,983,997,14,983,1399,0.014
3689,task_3689,1393,1398,5,1392,1415,0.007
3690,task_3690,425,436,11,425,809,0.008
3691,task_3691,103,109,6,102,118,0.011
3692,task_3692,568,579,11,568,678,0.007
3693,task_3693,831,842,11,831,896,0.007
3694,task_3694,765,775,10,765,837,0.005
3695,task_3695,1257,1268,11,1257,1379,0.006
3696,task_3696,83,97,14,83,445,0.01
3697,task_3697,214,223,9,210,1226,0.012
3698,task_3698,193,204,11,192,844,0.014
3699,task_3699,100,107,7,100,298,0.012
3700,task_3700,430,435,5,430,473,0.005
3701,task_3701,963,976,13,908,1414,0.014
3702,task_3702,692,697,5,690,1252,0.014
3703,task_3703,713,724,11,712,1087,0.009
3704,task_3704,870,884,14,854,1391,0.008
3705,task_3705,1338,1348,10,1338,1384,0.005
3706,task_3706,615,620,5,610,1163,0.013
3707,task_3707,564,570,6,558,1199,0.011
3708,task_3708,1357,1368,11,1357,1391,0.005
3709,task_3709,319,327,8,319,1382,0.014
3710,task_3710,207,212,5,206,1219,0.011
3711,task_3711,1128,1133,5,1127,1287,0.006
3712,task_3712,203,208,5,203,273,0.008
3713,task_3713,294,303,9,294,1041,0.008
3714,task_3714,630,643,13,630,1052,0.008
3715,task_3715,155,168,13,141,1402,0.005
3716,task_3716,1326,1332,6,1326,1374,0.009
3717,task_3717,1079,1092,13,1078,1208,0.006
3718,task_3718,272,279,7,272,706,0.007
3719,task_3719,988,995,7,988,1215,0.005
3720,task_3720,1359,1372,13,1359,1416,0.009
3721,task_3721,1247,1256,9,1247,1358,0.01
3722,task_3722,1043,1054,11,1042,1354,0.013
3723,task_3723,1022,1035,13,917,1429,0.009
3724,task_3724,878,889,11,878,926,0.012
3725,task_3725,1139,1151,12,1139,1305,0.013
3726,task_3726,1211,1224,13,1070,1432,0.005
3727,task_3727,1166,1172,6,1166,1265,0.008
3728,task_3728,718,723,5,713,1345,0.005
3729,task_3729,24,32,8,17,1182,0.012
3730,task_3730,340,348,8,340,666,0.005
3731,task_3731,1284,1297,13,1281,1342,0.014
3732,task_3732,1150,1157,7,1150,1172,0.005
3733,task_3733,1038,1046,8,1038,1184,0.007
3734,task_3734,446,451,5,446,1199,0.012
3735,task_3735,791,802,11,791,883,0.005
3736,task_3736,1229,1236,7,1229,1431,0.013
3737,task_3737,432,441,9,432,1361,0.005
3738,task_3738,878,887,9,878,1134,0.005
3739,task_3739,1065,1073,8,1028,1398,0.013
3740,task_3740,176,182,6,176,317,0.01
3741,task_3741,172,182,10,172,996,0.007
3742,task_3742,138,152,14,138,671,0.011
3743,task_3743,1022,1031,9,1022,1381,0.013
3744,task_3744,74,80,6,74,752,0.008
3745,task_3745,933,946,13,933,1166,0.011
3746,task_3746,532,541,9,531,988,0.01
3747,task_3747,1351,1359,8,1351,1395,0.007
3748,task_3748,1004,1011,7,1004,1091,0.013
3749,task_3749,801,813,12,801,1111,0.009
3750,task_3750,1104,1112,8,1104,1232,0.007
3751,task_3751,838,851,13,838,1039,0.008
3752,task_3752,1184,1198,14,1184,1354,0.012
3753,task_3753,196,208,12,195,961,0.013
3754,task_3754,454,459,5,454,866,0.011
3755,task_3755,1055,1069,14,1046,1384,0.01
3756,task_3756,838,847,9,835,1219,0.007
3757,task_3757,1050,1063,13,1050,1334,0.006
3758,task_3758,655,663,8,655,1080,0.007
3759,task_3759,1000,1014,14,1000,1219,0.007
3760,task_3760,629,634,5,629,1076,0.014
3761,task_3761,628,634,6,626,1397,0.014
3762,task_3762,453,459,6,453,1336,0.012
3763,task_3763,622,634,12,622,1029,0.005
3764,task_3764,701,709,8,701,770,0.012
3765,task_3765,1236,1246,10,1236,1390,0.014
3766,task_3766,152,164,12,152,246,0.01
3767,task_3767,909,922,13,899,1359,0.011
3768,task_3768,205,214,9,205,1130,0.013
3769,task_3769,553,566,13,552,1143,0.011
3770,task_3770,1051,1060,9,1051,1374,0.009
3771,task_3771,630,636,6,630,733,0.013
3772,task_3772,1287,1293,6,1282,1360,0.009
3773,task_3773,742,756,14,739,1334,0.006
3774,task_3774,610,617,7,610,1028,0.006
3775,task_3775,1181,1191,10,1146,1428,0.005
3776,task_3776,1036,1042,6,1033,1243,0.011
3777,task_3777,161,175,14,161,286,0.007
3778,task_3778,1046,1057,11,1033,1367,0.014
3779,task_3779,92,105,13,91,1322,0.009
3780,task_3780,1286,1293,7,1282,1347,0.012
3781,task_3781,757,763,6,755,1339,0.007
3782,task_3782,193,201,8,192,847,0.006
3783,task_3783,960,966,6,960,1143,0.006
3784,task_3784,1199,1211,12,1199,1348,0.011
3785,task_3785,405,412,7,403,1183,0.013
3786,task_3786,480,493,13,480,1382,0.009
3787,task_3787,320,326,6,320,956,0.01
3788,task_3788,260,273,13,260,1098,0.007
3789,task_3789,84,96,12,84,1100,0.012
3790,task_3790,385,390,5,384,1297,0.007
3791,task_3791,234,245,11,234,1245,0.009
3792,task_3792,847,856,9,847,949,0.009
3793,task_3793,692,704,12,692,773,0.009
3794,task_3794,863,868,5,863,1152,0.007
3795,task_3795,559,566,7,559,846,0.01
3796,task_3796,981,989,8,980,1095,0.007
3797,task_3797,1115,1126,11,1115,1154,0.007
3798,task_3798,345,355,10,345,1084,0.009
3799,task_3799,889,894,5,889,998,0.014
3800,task_3800,1244,1250,6,1244,1391,0.013
3801,task_3801,75,84,9,75,750,0.007
3802,task_3802,556,566,10,555,1131,0.005
3803,task_3803,320,334,14,320,1378,0.005
3804,task_3804,646,655,9,646,1294,0.014
3805,task_3805,1355,1364,9,1355,1374,0.005
3806,task_3806,752,766,14,752,913,0.007
3807,task_3807,1167,1177,10,1167,1242,0.014
3808,task_3808,1283,1295,12,1283,1330,0.013
3809,task_3809,1344,1352,8,1344,1380,0.006
3810,task_3810,1086,1092,6,1086,1251,0.013
3811,task_3811,631,643,12,631,1073,0.009
3812,task_3812,818,827,9,818,1182,0.01
3813,task_3813,178,189,11,178,901,0.014
3814,task_3814,733,741,8,732,1143,0.013
3815,task_3815,669,675,6,667,1304,0.01
3816,task_3816,1070,1083,13,1070,1300,0.009
3817,task_3817,1002,1012,10,1002,1218,0.01
3818,task_3818,569,580,11,569,818,0.008
3819,task_3819,1341,1354,13,1340,1387,0.012
3820,task_3820,1381,1394,13,1381,1415,0.013
3821,task_3821,502,515,13,502,753,0.009
3822,task_3822,22,30,8,22,411,0.008
3823,task_3823,807,814,7,807,867,0.006
3824,task_3824,787,801,14,787,1005,0.006
3825,task_3825,526,538,12,526,1005,0.007
3826,task_3826,831,840,9,831,1029,0.012
3827,task_3827,1153,1166,13,1153,1193,0.006
3828,task_3828,449,459,10,449,1079,0.009
3829,task_3829,930,943,13,929,1078,0.01
3830,task_3830,961,970,9,961,980,0.011
3831,task_3831,1241,1249,8,1241,1430,0.006
3832,task_3832,1011,1023,12,1009,1264,0.011
3833,task_3833,956,969,13,956,1031,0.007
3834,task_3834,1300,1305,5,1298,1405,0.007
3835,task_3835,1165,1170,5,1157,1394,0.005
3836,task_3836,922,928,6,922,1151,0.011
3837,task_3837,1320,1325,5,1303,1420,0.01
3838,task_3838,400,408,8,400,1184,0.006
3839,task_3839,813,826,13,813,1170,0.006
3840,task_3840,881,887,6,879,1155,0.01
3841,task_3841,1358,1370,12,1358,1425,0.013
3842,task_3842,250,262,12,250,1268,0.013
3843,task_3843,228,236,8,228,882,0.006
3844,task_3844,1179,1192,13,1171,1413,0.013
3845,task_3845,645,656,11,645,1204,0.009
3846,task_3846,589,594,5,496,1403,0.007
3847,task_3847,565,575,10,562,1244,0.005
3848,task_3848,1086,1098,12,1085,1321,0.009
3849,task_3849,1314,1320,6,1314,1375,0.008
3850,task_3850,987,1001,14,979,1424,0.008
3851,task_3851,122,129,7,122,746,0.005
3852,task_3852,1148,1157,9,1148,1370,0.009
3853,task_3853,23,28,5,23,207,0.009
3854,task_3854,658,671,13,658,696,0.01
3855,task_3855,1138,1150,12,1083,1424,0.011
3856,task_3856,766,774,8,766,1339,0.011
3857,task_3857,468,476,8,468,1202,0.006
3858,task_3858,1191,1201,10,1185,1341,0.009
3859,task_3859,454,464,10,454,1077,0.01
3860,task_3860,1400,1407,7,1394,1438,0.005
3861,task_3861,853,861,8,853,1024,0.01
3862,task_3862,922,927,5,918,1218,0.01
3863,task_3863,513,527,14,511,1206,0.013
3864,task_3864,678,683,5,678,958,0.014
3865,task_3865,992,998,6,992,1244,0.011
3866,task_3866,1391,1405,14,1391,1436,0.007
3867,task_3867,46,55,9,46,490,0.005
3868,task_3868,1290,1303,13,1289,1391,0.009
3869,task_3869,670,678,8,670,701,0.013
3870,task_3870,946,951,5,946,1284,0.014
3871,task_3871,1049,1063,14,1049,1116,0.01
3872,task_3872,1346,1353,7,1346,1371,0.011
3873,task_3873,947,960,13,947,1013,0.01
3874,task_3874,1108,1114,6,1107,1263,0.014
3875,task_3875,1313,1318,5,1313,1332,0.005
3876,task_3876,522,535,13,521,1243,0.009
3877,task_3877,852,859,7,851,1051,0.013
3878,task_3878,568,578,10,550,1343,0.008
3879,task_3879,20,28,8,20,447,0.006
3880,task_3880,32,45,13,32,194,0.006
3881,task_3881,1235,1244,9,1235,1341,0.01
3882,task_3882,722,729,7,721,1202,0.01
3883,task_3883,852,865,13,852,918,0.006
3884,task_3884,1092,1105,13,1091,1332,0.013
3885,task_3885,796,802,6,796,825,0.01
3886,task_3886,803,809,6,803,919,0.012
3887,task_3887,253,266,13,253,1330,0.01
3888,task_3888,841,848,7,838,1336,0.009
3889,task_3889,499,511,12,499,999,0.01
3890,task_3890,20,33,13,20,584,0.009
3891,task_3891,509,520,11,509,865,0.01
3892,task_3892,101,113,12,101,238,0.013
3893,task_3893,920,925,5,920,960,0.005
3894,task_3894,692,703,11,689,1134,0.013
3895,task_3895,502,510,8,502,1114,0.005
3896,task_3896,960,974,14,928,1395,0.008
3897,task_3897,996,1007,11,996,1154,0.012
3898,task_3898,618,625,7,617,981,0.01
3899,task_3899,790,798,8,787,1113,0.009
3900,task_3900,762,769,7,762,789,0.007
3901,task_3901,1175,1189,14,1175,1292,0.01
3902,task_3902,642,647,5,632,1405,0.008
3903,task_3903,683,695,12,682,1153,0.012
3904,task_3904,651,659,8,651,730,0.007
3905,task_3905,113,120,7,112,591,0.014
3906,task_3906,790,800,10,790,823,0.013
3907,task_3907,945,958,13,945,1107,0.008
3908,task_3908,1135,1149,14,1135,1253,0.005
3909,task_3909,573,586,13,572,1105,0.014
3910,task_3910,222,227,5,220,1191,0.014
3911,task_3911,359,373,14,359,746,0.01
3912,task_3912,825,835,10,825,1206,0.014
3913,task_3913,592,597,5,592,1013,0.008
3914,task_3914,376,388,12,376,1018,0.006
3915,task_3915,803,812,9,803,854,0.007
3916,task_3916,433,441,8,433,1307,0.008
3917,task_3917,334,339,5,334,840,0.006
3918,task_3918,752,758,6,752,1016,0.012
3919,task_3919,718,725,7,717,1151,0.008
3920,task_3920,131,141,10,129,482,0.006
3921,task_3921,1134,1143,9,1134,1198,0.01
3922,task_3922,345,356,11,345,1258,0.014
3923,task_3923,758,771,13,758,1301,0.011
3924,task_3924,357,362,5,357,1181,0.006
3925,task_3925,1095,1101,6,1095,1251,0.007
3926,task_3926,357,369,12,354,1194,0.007
3927,task_3927,354,367,13,354,505,0.009
3928,task_3928,1218,1224,6,1016,1427,0.012
3929,task_3929,567,575,8,567,768,0.013
3930,task_3930,793,803,10,793,816,0.01
3931,task_3931,184,194,10,184,1193,0.006
3932,task_3932,325,335,10,325,780,0.008
3933,task_3933,1243,1255,12,1243,1281,0.014
3934,task_3934,209,222,13,201,1414,0.011
3935,task_3935,1225,1235,10,1225,1267,0.008
3936,task_3936,1031,1039,8,1031,1123,0.005
3937,task_3937,487,498,11,484,1201,0.012
3938,task_3938,559,569,10,559,683,0.01
3939,task_3939,60,73,13,60,557,0.012
3940,task_3940,301,310,9,296,1172,0.011
3941,task_3941,1176,1185,9,1167,1392,0.013
3942,task_3942,65,77,12,64,1414,0.01
3943,task_3943,859,868,9,859,941,0.007
3944,task_3944,317,331,14,317,1395,0.008
3945,task_3945,1330,1337,7,1330,1365,0.005
3946,task_3946,694,700,6,694,1064,0.007
3947,task_3947,1121,1127,6,1121,1153,0.011
3948,task_3948,588,601,13,486,1404,0.012
3949,task_3949,1315,1324,9,1313,1396,0.012
3950,task_3950,982,996,14,982,1214,0.012
3951,task_3951,1239,1248,9,1239,1422,0.014
3952,task_3952,691,699,8,691,989,0.007
3953,task_3953,1235,1246,11,1234,1418,0.005
3954,task_3954,540,550,10,539,1091,0.014
3955,task_3955,127,134,7,127,721,0.011
3956,task_3956,318,330,12,318,1347,0.005
3957,task_3957,1035,1046,11,1035,1186,0.005
3958,task_3958,474,481,7,474,555,0.012
3959,task_3959,1063,1077,14,1057,1345,0.013
3960,task_3960,364,376,12,364,395,0.006
3961,task_3961,54,66,12,54,304,0.013
3962,task_3962,518,526,8,518,1023,0.009
3963,task_3963,983,989,6,982,1240,0.012
3964,task_3964,961,971,10,961,1276,0.013
3965,task_3965,924,934,10,924,959,0.009
3966,task_3966,832,839,7,832,1024,0.014
3967,task_3967,921,933,12,921,1070,0.01
3968,task_3968,19,24,5,18,877,0.013
3969,task_3969,925,931,6,919,1338,0.006
3970,task_3970,536,546,10,536,770,0.008
3971,task_3971,845,850,5,844,1172,0.014
3972,task_3972,849,854,5,825,1364,0.007
3973,task_3973,1221,1229,8,1221,1249,0.007
3974,task_3974,1101,1110,9,1098,1336,0.013
3975,task_3975,803,809,6,800,1197,0.012
3976,task_3976,15,28,13,13,1245,0.013
3977,task_3977,158,165,7,158,694,0.012
3978,task_3978,336,341,5,334,1164,0.012
3979,task_3979,692,703,11,691,1239,0.013
3980,task_3980,467,478,11,467,1008,0.008
3981,task_3981,1366,1372,6,1366,1397,0.008
3982,task_3982,904,913,9,899,1300,0.011
3983,task_3983,1016,1022,6,1016,1069,0.01
3984,task_3984,885,894,9,885,1094,0.007
3985,task_3985,835,841,6,835,1011,0.014
3986,task_3986,42,52,10,42,882,0.006
3987,task_3987,615,628,13,607,1153,0.011
3988,task_3988,171,180,9,171,265,0.01
3989,task_3989,1266,1271,5,1266,1286,0.009
3990,task_3990,1365,1379,14,1365,1411,0.008
3991,task_3991,428,438,10,428,739,0.006
3992,task_3992,1004,1017,13,1003,1251,0.014
3993,task_3993,877,885,8,877,1366,0.011
3994,task_3994,1027,1038,11,1027,1136,0.012
3995,task_3995,305,316,11,305,462,0.011
3996,task_3996,379,384,5,364,1400,0.006
3997,task_3997,29,38,9,28,1089,0.013
3998,task_3998,134,142,8,129,1382,0.012
3999,task_3999,1274,1288,14,1274,1306,0.014
4000,task_4000,208,220,12,206,1343,0.012
4001,task_4001,947,954,7,947,1287,0.012
4002,task_4002,401,409,8,395,1349,0.013
4003,task_4003,1064,1076,12,1064,1272,0.009
4004,task_4004,601,615,14,601,756,0.011
4005,task_4005,47,56,9,47,902,0.013
4006,task_4006,133,138,5,133,1250,0.007
4007,task_4007,136,143,7,136,1075,0.013
4008,task_4008,430,435,5,430,1394,0.005
4009,task_4009,1172,1184,12,1168,1331,0.005
4010,task_4010,407,412,5,407,453,0.008
4011,task_4011,1105,1113,8,1105,1207,0.005
4012,task_4012,823,829,6,823,849,0.006
4013,task_4013,1267,1281,14,1267,1306,0.01
4014,task_4014,769,774,5,769,1011,0.01
4015,task_4015,554,568,14,550,1256,0.012
4016,task_4016,92,98,6,92,413,0.009
4017,task_4017,454,467,13,454,745,0.011
4018,task_4018,199,206,7,199,513,0.01
4019,task_4019,1382,1390,8,1368,1438,0.012
4020,task_4020,833,845,12,832,1050,0.013
4021,task_4021,1096,1106,10,1092,1393,0.008
4022,task_4022,814,824,10,814,1225,0.014
4023,task_4023,882,887,5,882,978,0.006
4024,task_4024,1143,1149,6,1141,1359,0.009
4025,task_4025,1208,1213,5,1207,1414,0.008
4026,task_4026,4,13,9,4,824,0.012
4027,task_4027,839,853,14,839,946,0.011
4028,task_4028,1174,1187,13,1169,1348,0.01
4029,task_4029,781,792,11,781,897,0.012
4030,task_4030,774,786,12,773,1404,0.012
4031,task_4031,266,279,13,265,1281,0.005
4032,task_4032,917,922,5,902,1393,0.005
4033,task_4033,1362,1376,14,1360,1435,0.012
4034,task_4034,869,881,12,869,1102,0.009
4035,task_4035,1271,1285,14,1271,1390,0.008
4036,task_4036,407,421,14,407,753,0.011
4037,task_4037,75,81,6,75,562,0.014
4038,task_4038,972,981,9,972,1142,0.006
4039,task_4039,197,203,6,197,825,0.006
4040,task_4040,671,676,5,671,1317,0.005
4041,task_4041,892,906,14,892,1277,0.014
4042,task_4042,608,614,6,608,1054,0.012
4043,task_4043,1147,1157,10,1147,1298,0.011
4044,task_4044,1233,1241,8,1102,1434,0.005
4045,task_4045,1357,1366,9,1356,1434,0.014
4046,task_4046,265,276,11,265,763,0.014
4047,task_4047,794,804,10,794,878,0.012
4048,task_4048,351,359,8,351,425,0.013
4049,task_4049,118,125,7,110,1380,0.006
4050,task_4050,699,713,14,699,1020,0.011
4051,task_4051,564,569,5,561,1170,0.011
4052,task_4052,941,955,14,941,1134,0.006
4053,task_4053,1006,1011,5,1006,1307,0.007
4054,task_4054,573,584,11,572,1071,0.012
4055,task_4055,857,866,9,854,1327,0.01
4056,task_4056,1308,1318,10,1307,1403,0.014
4057,task_4057,1246,1253,7,1245,1322,0.011
4058,task_4058,778,790,12,777,1051,0.005
4059,task_4059,721,727,6,721,897,0.014
4060,task_4060,132,139,7,132,294,0.009
4061,task_4061,260,273,13,260,1267,0.006
4062,task_4062,903,912,9,903,1157,0.013
4063,task_4063,427,438,11,427,699,0.006
4064,task_4064,1246,1253,7,1244,1394,0.01
4065,task_4065,1371,1380,9,1364,1430,0.01
4066,task_4066,79,92,13,79,1391,0.011
4067,task_4067,111,125,14,111,568,0.006
4068,task_4068,883,897,14,883,929,0.008
4069,task_4069,1340,1350,10,1340,1369,0.011
4070,task_4070,796,803,7,796,854,0.008
4071,task_4071,926,938,12,901,1403,0.01
4072,task_4072,937,944,7,935,1078,0.014
4073,task_4073,345,357,12,345,824,0.011
4074,task_4074,80,93,13,80,159,0.008
4075,task_4075,129,141,12,129,257,0.009
4076,task_4076,584,598,14,584,876,0.006
4077,task_4077,1138,1150,12,1124,1423,0.013
4078,task_4078,426,433,7,426,973,0.007
4079,task_4079,932,942,10,931,1095,0.008
4080,task_4080,155,164,9,155,604,0.009
4081,task_4081,872,883,11,872,1177,0.011
4082,task_4082,897,905,8,896,1061,0.01
4083,task_4083,516,527,11,516,1077,0.006
4084,task_4084,727,741,14,727,1184,0.007
4085,task_4085,1227,1236,9,1227,1339,0.007
4086,task_4086,896,902,6,896,1014,0.009
4087,task_4087,1110,1124,14,1109,1182,0.005
4088,task_4088,1042,1054,12,1042,1075,0.011
4089,task_4089,552,564,12,551,1002,0.01
4090,task_4090,99,109,10,99,1268,0.009
4091,task_4091,516,525,9,516,875,0.01
4092,task_4092,941,954,13,941,1040,0.008
4093,task_4093,414,427,13,414,499,0.011
4094,task_4094,952,961,9,949,1337,0.013
4095,task_4095,8,22,14,8,774,0.007
4096,task_4096,605,610,5,605,1173,0.005
4097,task_4097,307,318,11,307,1247,0.01
4098,task_4098,1298,1305,7,1298,1338,0.009
4099,task_4099,1391,1400,9,1391,1417,0.01
4100,task_4100,802,809,7,802,1002,0.011
4101,task_4101,4,18,14,4,689,0.009
4102,task_4102,1193,1198,5,1187,1348,0.014
4103,task_4103,557,566,9,557,662,0.008
4104,task_4104,120,126,6,120,1331,0.008
4105,task_4105,40,51,11,40,152,0.005
4106,task_4106,1081,1091,10,1079,1384,0.009
4107,task_4107,859,871,12,859,1185,0.012
4108,task_4108,178,192,14,178,1051,0.014
4109,task_4109,1348,1362,14,1348,1395,0.005
4110,task_4110,800,806,6,800,1109,0.007
4111,task_4111,370,381,11,369,1118,0.005
4112,task_4112,78,87,9,78,587,0.009
4113,task_4113,1226,1233,7,1181,1431,0.011
4114,task_4114,957,969,12,957,1198,0.008
4115,task_4115,655,663,8,655,1021,0.005
4116,task_4116,1048,1053,5,1048,1076,0.011
4117,task_4117,439,452,13,439,1021,0.013
4118,task_4118,379,386,7,374,1401,0.012
4119,task_4119,567,580,13,559,1277,0.012
4120,task_4120,1252,1266,14,1252,1331,0.009
4121,task_4121,397,406,9,397,1236,0.007
4122,task_4122,281,290,9,281,483,0.014
4123,task_4123,99,104,5,99,969,0.011
4124,task_4124,861,874,13,837,1378,0.014
4125,task_4125,466,473,7,466,1192,0.011
4126,task_4126,479,486,7,479,1099,0.013
4127,task_4127,566,576,10,566,719,0.011
4128,task_4128,893,902,9,893,1205,0.012
4129,task_4129,59,64,5,59,217,0.009
4130,task_4130,700,714,14,700,990,0.006
4131,task_4131,57,67,10,57,300,0.005
4132,task_4132,580,588,8,575,1368,0.012
4133,task_4133,183,191,8,183,969,0.012
4134,task_4134,1305,1310,5,1305,1337,0.008
4135,task_4135,41,53,12,41,361,0.006
4136,task_4136,856,866,10,856,1226,0.008
4137,task_4137,81,89,8,81,1217,0.013
4138,task_4138,196,208,12,196,469,0.007
4139,task_4139,1324,1330,6,1322,1360,0.014
4140,task_4140,255,267,12,255,1435,0.007
4141,task_4141,1304,1310,6,1304,1351,0.009
4142,task_4142,857,870,13,857,1039,0.013
4143,task_4143,1087,1094,7,1086,1336,0.007
4144,task_4144,30,42,12,30,1022,0.014
4145,task_4145,570,582,12,570,1020,0.011
4146,task_4146,1157,1164,7,1157,1244,0.006
4147,task_4147,461,469,8,461,894,0.009
4148,task_4148,424,430,6,424,1179,0.008
4149,task_4149,694,705,11,694,967,0.01
4150,task_4150,245,251,6,245,263,0.007
4151,task_4151,497,502,5,497,956,0.011
4152,task_4152,1288,1301,13,1288,1341,0.009
4153,task_4153,1153,1166,13,1152,1420,0.009
4154,task_4154,570,576,6,570,696,0.005
4155,task_4155,280,291,11,280,1409,0.013
4156,task_4156,272,282,10,272,326,0.006
4157,task_4157,323,337,14,323,677,0.009
4158,task_4158,372,385,13,366,1334,0.012
4159,task_4159,1186,1199,13,1186,1279,0.006
4160,task_4160,805,816,11,805,1234,0.005
4161,task_4161,1198,1209,11,1198,1371,0.005
4162,task_4162,217,224,7,217,675,0.01
4163,task_4163,1229,1242,13,1141,1438,0.006
4164,task_4164,471,482,11,471,883,0.006
4165,task_4165,495,508,13,495,614,0.007
4166,task_4166,268,273,5,268,1396,0.007
4167,task_4167,95,103,8,95,606,0.01
4168,task_4168,779,786,7,779,1188,0.009
4169,task_4169,1340,1350,10,1340,1363,0.012
4170,task_4170,435,440,5,435,828,0.01
4171,task_4171,986,993,7,986,1180,0.013
4172,task_4172,637,645,8,637,843,0.008
4173,task_4173,1078,1090,12,1078,1114,0.008
4174,task_4174,327,339,12,327,934,0.013
4175,task_4175,218,226,8,218,1136,0.006
4176,task_4176,210,221,11,210,939,0.008
4177,task_4177,999,1012,13,999,1349,0.013
4178,task_4178,1236,1248,12,1236,1385,0.008
4179,task_4179,227,241,14,227,987,0.01
4180,task_4180,1094,1100,6,1094,1222,0.006
4181,task_4181,825,834,9,825,900,0.006
4182,task_4182,1294,1308,14,1294,1331,0.009
4183,task_4183,553,566,13,553,588,0.013
4184,task_4184,947,959,12,936,1343,0.013
4185,task_4185,501,512,11,501,692,0.012
4186,task_4186,1346,1354,8,1346,1388,0.007
4187,task_4187,108,117,9,108,779,0.007
4188,task_4188,1132,1145,13,1132,1359,0.011
4189,task_4189,66,80,14,66,1077,0.008
4190,task_4190,1186,1191,5,1186,1214,0.005
4191,task_4191,250,261,11,250,1203,0.007
4192,task_4192,575,586,11,573,1298,0.01
4193,task_4193,445,455,10,445,924,0.005
4194,task_4194,654,668,14,654,921,0.01
4195,task_4195,1259,1266,7,1258,1292,0.011
4196,task_4196,1350,1361,11,1312,1436,0.006
4197,task_4197,536,545,9,536,1040,0.012
4198,task_4198,543,556,13,543,662,0.006
4199,task_4199,901,913,12,901,1024,0.012
4200,task_4200,120,125,5,120,1406,0.011
4201,task_4201,134,147,13,131,1407,0.007
4202,task_4202,485,492,7,485,686,0.009
4203,task_4203,46,59,13,46,856,0.009
4204,task_4204,1257,1264,7,1256,1335,0.014
4205,task_4205,663,677,14,663,1098,0.007
4206,task_4206,1118,1127,9,1118,1244,0.013
4207,task_4207,931,937,6,931,1062,0.005
4208,task_4208,392,401,9,392,516,0.014
4209,task_4209,1310,1320,10,1310,1377,0.012
4210,task_4210,604,617,13,604,796,0.008
4211,task_4211,1122,1131,9,1120,1366,0.01
4212,task_4212,970,978,8,970,1020,0.006
4213,task_4213,428,441,13,428,1172,0.006
4214,task_4214,324,332,8,324,525,0.005
4215,task_4215,96,110,14,96,855,0.007
4216,task_4216,135,143,8,135,737,0.014
4217,task_4217,773,779,6,772,980,0.013
4218,task_4218,1366,1373,7,1365,1404,0.014
4219,task_4219,920,934,14,920,1015,0.007
4220,task_4220,28,38,10,28,103,0.014
4221,task_4221,1335,1344,9,1334,1401,0.01
4222,task_4222,1310,1322,12,1310,1332,0.006
4223,task_4223,1150,1158,8,1150,1314,0.013
4224,task_4224,1313,1321,8,1312,1376,0.005
4225,task_4225,878,883,5,778,1397,0.005
4226,task_4226,1317,1325,8,1317,1384,0.009
4227,task_4227,123,136,13,123,327,0.009
4228,task_4228,781,793,12,781,1006,0.005
4229,task_4229,204,217,13,204,875,0.012
4230,task_4230,1139,1151,12,1121,1427,0.007
4231,task_4231,1130,1137,7,1126,1358,0.01
4232,task_4232,17,25,8,17,668,0.009
4233,task_4233,596,606,10,595,1019,0.013
4234,task_4234,1273,1284,11,1268,1402,0.005
4235,task_4235,347,361,14,347,1375,0.007
4236,task_4236,1173,1181,8,1173,1243,0.008
4237,task_4237,399,410,11,399,859,0.011
4238,task_4238,655,662,7,652,1150,0.013
4239,task_4239,39,49,10,39,858,0.005
4240,task_4240,241,248,7,241,662,0.008
4241,task_4241,823,832,9,823,1101,0.005
4242,task_4242,1308,1317,9,1308,1409,0.012
4243,task_4243,318,326,8,318,458,0.008
4244,task_4244,548,553,5,548,830,0.012
4245,task_4245,1138,1147,9,1138,1295,0.007
4246,task_4246,36,46,10,36,930,0.012
4247,task_4247,741,746,5,741,763,0.013
4248,task_4248,842,852,10,842,1152,0.014
4249,task_4249,789,803,14,788,971,0.012
4250,task_4250,891,899,8,885,1346,0.005
4251,task_4251,1399,1405,6,1399,1420,0.008
4252,task_4252,1143,1154,11,1143,1286,0.005
4253,task_4253,664,676,12,664,1202,0.013
4254,task_4254,733,744,11,733,779,0.012
4255,task_4255,775,780,5,501,1433,0.007
4256,task_4256,1180,1193,13,1148,1425,0.014
4257,task_4257,178,184,6,178,1190,0.005
4258,task_4258,608,617,9,607,895,0.01
4259,task_4259,4,17,13,4,102,0.008
4260,task_4260,670,677,7,670,946,0.013
4261,task_4261,1182,1195,13,1182,1252,0.005
4262,task_4262,943,952,9,943,1197,0.009
4263,task_4263,662,668,6,662,778,0.014
4264,task_4264,101,111,10,101,812,0.014
4265,task_4265,126,136,10,125,1081,0.007
4266,task_4266,115,128,13,115,257,0.009
4267,task_4267,56,70,14,56,232,0.014
4268,task_4268,897,905,8,896,1179,0.008
4269,task_4269,700,711,11,693,1305,0.012
4270,task_4270,1052,1062,10,1052,1245,0.014
4271,task_4271,526,540,14,526,867,0.014
4272,task_4272,965,976,11,927,1414,0.009
4273,task_4273,145,153,8,144,807,0.013
4274,task_4274,1038,1045,7,1038,1114,0.007
4275,task_4275,598,606,8,595,1390,0.007
4276,task_4276,126,132,6,126,1359,0.009
4277,task_4277,1170,1184,14,1170,1307,0.014
4278,task_4278,1128,1142,14,1128,1173,0.012
4279,task_4279,390,397,7,390,745,0.006
4280,task_4280,1094,1101,7,1093,1237,0.008
4281,task_4281,77,82,5,77,923,0.005
4282,task_4282,752,763,11,751,1363,0.013
4283,task_4283,271,278,7,269,1109,0.01
4284,task_4284,912,920,8,910,1240,0.013
4285,task_4285,521,530,9,520,822,0.008
4286,task_4286,869,882,13,867,1298,0.012
4287,task_4287,167,173,6,167,513,0.006
4288,task_4288,1398,1409,11,1398,1420,0.012
4289,task_4289,384,391,7,383,1056,0.006
4290,task_4290,465,477,12,465,1210,0.013
4291,task_4291,990,1003,13,990,1367,0.014
4292,task_4292,393,404,11,352,1426,0.01
4293,task_4293,452,462,10,452,905,0.013
4294,task_4294,667,679,12,666,828,0.012
4295,task_4295,803,816,13,803,1136,0.006
4296,task_4296,671,681,10,671,1295,0.006
4297,task_4297,811,823,12,811,1274,0.01
4298,task_4298,674,683,9,672,964,0.007
4299,task_4299,389,402,13,389,893,0.013
4300,task_4300,1379,1384,5,1379,1421,0.011
4301,task_4301,933,939,6,931,1124,0.013
4302,task_4302,959,965,6,948,1369,0.005
4303,task_4303,520,529,9,520,559,0.008
4304,task_4304,1255,1262,7,1247,1436,0.007
4305,task_4305,550,557,7,550,1198,0.013
4306,task_4306,237,242,5,237,1371,0.011
4307,task_4307,1243,1248,5,1072,1434,0.011
4308,task_4308,5,19,14,5,590,0.006
4309,task_4309,774,780,6,773,1003,0.012
4310,task_4310,984,996,12,984,1386,0.005
4311,task_4311,470,480,10,470,592,0.011
4312,task_4312,1188,1202,14,1188,1223,0.009
4313,task_4313,1118,1125,7,1118,1232,0.011
4314,task_4314,1358,1363,5,1358,1427,0.008
4315,task_4315,1178,1188,10,1178,1253,0.012
4316,task_4316,222,227,5,222,967,0.006
4317,task_4317,154,168,14,154,190,0.005
4318,task_4318,921,928,7,921,1188,0.012
4319,task_4319,297,311,14,297,710,0.008
4320,task_4320,845,857,12,844,1185,0.007
4321,task_4321,421,429,8,421,753,0.009
4322,task_4322,0,10,10,0,782,0.013
4323,task_4323,219,229,10,214,1376,0.014
4324,task_4324,1171,1177,6,1171,1207,0.011
4325,task_4325,835,846,11,835,991,0.007
4326,task_4326,638,645,7,637,1307,0.009
4327,task_4327,691,700,9,691,754,0.011
4328,task_4328,281,294,13,281,757,0.005
4329,task_4329,423,437,14,423,701,0.014
4330,task_4330,500,513,13,494,1161,0.006
4331,task_4331,290,301,11,290,760,0.006
4332,task_4332,1196,1207,11,1196,1258,0.006
4333,task_4333,527,534,7,527,1309,0.013
4334,task_4334,599,608,9,599,1095,0.014
4335,task_4335,615,620,5,615,1090,0.007
4336,task_4336,1228,1236,8,1209,1432,0.009
4337,task_4337,1300,1310,10,1298,1405,0.008
4338,task_4338,1324,1338,14,1322,1373,0.007
4339,task_4339,52,59,7,52,180,0.006
4340,task_4340,31,40,9,31,1279,0.014
4341,task_4341,1035,1041,6,1032,1204,0.013
4342,task_4342,863,869,6,863,1018,0.013
4343,task_4343,992,1000,8,992,1157,0.008
4344,task_4344,240,245,5,240,1225,0.012
4345,task_4345,813,823,10,805,1304,0.01
4346,task_4346,431,444,13,431,1257,0.005
4347,task_4347,882,895,13,882,1116,0.008
4348,task_4348,372,385,13,371,1308,0.006
4349,task_4349,1229,1240,11,1229,1380,0.006
4350,task_4350,55,65,10,55,548,0.011
4351,task_4351,388,394,6,388,1005,0.011
4352,task_4352,886,891,5,886,1266,0.006
4353,task_4353,196,208,12,191,1253,0.005
4354,task_4354,1332,1345,13,1331,1399,0.014
4355,task_4355,88,99,11,88,219,0.01
4356,task_4356,1297,1309,12,1297,1378,0.011
4357,task_4357,797,808,11,793,1143,0.005
4358,task_4358,493,499,6,483,1249,0.005
4359,task_4359,944,957,13,944,1265,0.009
4360,task_4360,1209,1216,7,1188,1424,0.014
4361,task_4361,333,342,9,333,1047,0.013
4362,task_4362,1348,1359,11,1348,1369,0.006
4363,task_4363,589,596,7,589,1364,0.01
4364,task_4364,175,189,14,175,460,0.013
4365,task_4365,569,579,10,563,1353,0.007
4366,task_4366,871,877,6,871,992,0.005
4367,task_4367,676,686,10,673,1194,0.012
4368,task_4368,1286,1294,8,1286,1357,0.011
4369,task_4369,1203,1209,6,1203,1231,0.007
4370,task_4370,1385,1396,11,1385,1427,0.006
4371,task_4371,1205,1211,6,1205,1232,0.01
4372,task_4372,1306,1318,12,1306,1369,0.01
4373,task_4373,780,792,12,780,945,0.014
4374,task_4374,1339,1349,10,1339,1408,0.006
4375,task_4375,754,763,9,754,1010,0.005
4376,task_4376,938,945,7,929,1283,0.006
4377,task_4377,103,116,13,103,386,0.01
4378,task_4378,1068,1081,13,1068,1301,0.011
4379,task_4379,684,693,9,681,1313,0.012
4380,task_4380,847,855,8,847,933,0.008
4381,task_4381,454,467,13,454,831,0.013
4382,task_4382,517,524,7,517,696,0.008
4383,task_4383,1292,1300,8,1286,1393,0.01
4384,task_4384,377,384,7,377,958,0.005
4385,task_4385,415,427,12,415,990,0.013
4386,task_4386,305,316,11,303,964,0.013
4387,task_4387,1190,1199,9,1189,1313,0.007
4388,task_4388,666,678,12,666,726,0.008
4389,task_4389,1121,1132,11,1121,1185,0.005
4390,task_4390,590,597,7,590,716,0.008
4391,task_4391,1216,1229,13,1216,1260,0.011
4392,task_4392,1383,1388,5,1383,1427,0.014
4393,task_4393,534,548,14,527,1367,0.012
4394,task_4394,787,797,10,787,969,0.007
4395,task_4395,876,887,11,876,1165,0.009
4396,task_4396,594,608,14,594,1012,0.008
4397,task_4397,562,574,12,561,863,0.007
4398,task_4398,1100,1105,5,1100,1171,0.01
4399,task_4399,870,880,10,866,1326,0.006
4400,task_4400,921,929,8,919,1155,0.013
4401,task_4401,1242,1248,6,1045,1434,0.01
4402,task_4402,280,285,5,280,1348,0.011
4403,task_4403,146,160,14,146,1167,0.012
4404,task_4404,1263,1270,7,1263,1324,0.005
4405,task_4405,1020,1027,7,1020,1262,0.014
4406,task_4406,1130,1135,5,1130,1316,0.009
4407,task_4407,225,235,10,225,758,0.007
4408,task_4408,1089,1101,12,1089,1181,0.008
4409,task_4409,571,581,10,570,1316,0.009
4410,task_4410,937,942,5,937,1220,0.007
4411,task_4411,235,240,5,235,618,0.006
4412,task_4412,459,467,8,459,594,0.009
4413,task_4413,899,906,7,898,1213,0.006
4414,task_4414,1158,1164,6,1154,1386,0.014
4415,task_4415,783,795,12,782,1044,0.013
4416,task_4416,74,86,12,74,918,0.011
4417,task_4417,160,171,11,160,1258,0.008
4418,task_4418,220,234,14,220,279,0.01
4419,task_4419,1321,1329,8,1267,1427,0.005
4420,task_4420,1184,1198,14,1184,1369,0.011
4421,task_4421,201,209,8,195,1323,0.012
4422,task_4422,1297,1304,7,1282,1416,0.006
4423,task_4423,148,157,9,140,1291,0.01
4424,task_4424,368,378,10,368,717,0.014
4425,task_4425,393,401,8,392,1035,0.005
4426,task_4426,404,415,11,403,1069,0.005
4427,task_4427,1036,1050,14,1036,1140,0.006
4428,task_4428,46,57,11,46,1369,0.005
4429,task_4429,1177,1191,14,1177,1344,0.011
4430,task_4430,109,120,11,109,529,0.006
4431,task_4431,38,50,12,38,1058,0.012
4432,task_4432,1122,1133,11,1091,1407,0.01
4433,task_4433,1243,1257,14,1243,1359,0.014
4434,task_4434,979,987,8,979,1077,0.007
4435,task_4435,933,944,11,929,1099,0.009
4436,task_4436,719,726,7,719,1177,0.014
4437,task_4437,204,209,5,204,796,0.013
4438,task_4438,201,209,8,201,993,0.013
4439,task_4439,126,140,14,123,1249,0.005
4440,task_4440,854,859,5,853,1201,0.006
4441,task_4441,449,455,6,449,1193,0.014
4442,task_4442,990,995,5,990,1084,0.006
4443,task_4443,704,713,9,704,1088,0.013
4444,task_4444,59,64,5,59,623,0.013
4445,task_4445,766,778,12,764,1355,0.008
4446,task_4446,832,838,6,832,925,0.012
4447,task_4447,1373,1385,12,1373,1418,0.014
4448,task_4448,818,828,10,818,893,0.009
4449,task_4449,1183,1191,8,1183,1328,0.008
4450,task_4450,1277,1287,10,1276,1372,0.013
4451,task_4451,1268,1275,7,1268,1352,0.014
4452,task_4452,470,475,5,470,904,0.011
4453,task_4453,554,566,12,548,1338,0.009
4454,task_4454,327,339,12,327,383,0.006
4455,task_4455,948,959,11,948,1165,0.012
4456,task_4456,424,436,12,424,1110,0.013
4457,task_4457,57,65,8,57,1106,0.01
4458,task_4458,1082,1095,13,1082,1262,0.009
4459,task_4459,524,532,8,524,649,0.013
4460,task_4460,58,63,5,58,266,0.005
4461,task_4461,582,592,10,582,1065,0.014
4462,task_4462,1320,1325,5,1312,1422,0.009
4463,task_4463,13,21,8,13,57,0.011
4464,task_4464,1175,1189,14,1175,1287,0.01
4465,task_4465,774,786,12,774,952,0.008
4466,task_4466,312,324,12,311,1074,0.007
4467,task_4467,381,392,11,381,856,0.005
4468,task_4468,1317,1326,9,1317,1383,0.009
4469,task_4469,2,15,13,2,228,0.011
4470,task_4470,1255,1262,7,1248,1435,0.013
4471,task_4471,376,389,13,375,916,0.01
4472,task_4472,1075,1085,10,1042,1425,0.007
4473,task_4473,917,929,12,917,1287,0.01
4474,task_4474,833,841,8,830,1102,0.012
4475,task_4475,996,1005,9,996,1293,0.008
4476,task_4476,289,302,13,289,457,0.006
4477,task_4477,1021,1028,7,1021,1133,0.012
4478,task_4478,825,839,14,825,901,0.011
4479,task_4479,6,19,13,6,806,0.009
4480,task_4480,1259,1273,14,1258,1285,0.014
4481,task_4481,889,899,10,880,1334,0.012
4482,task_4482,216,230,14,216,896,0.007
4483,task_4483,275,287,12,275,649,0.009
4484,task_4484,1325,1332,7,1271,1427,0.012
4485,task_4485,1170,1183,13,1168,1292,0.012
4486,task_4486,19,26,7,19,247,0.009
4487,task_4487,0,14,14,0,1204,0.012
4488,task_4488,690,700,10,690,898,0.007
4489,task_4489,16,24,8,16,361,0.01
4490,task_4490,322,333,11,322,1077,0.012
4491,task_4491,101,112,11,101,866,0.01
4492,task_4492,1062,1076,14,1061,1317,0.01
4493,task_4493,849,856,7,841,1364,0.013
4494,task_4494,106,119,13,106,1267,0.006
4495,task_4495,780,791,11,779,1331,0.01
4496,task_4496,293,307,14,293,742,0.011
4497,task_4497,837,848,11,830,1139,0.01
4498,task_4498,209,215,6,196,1337,0.007
4499,task_4499,262,268,6,262,1426,0.007
4500,task_4500,912,926,14,912,1066,0.009
4501,task_4501,848,855,7,848,1338,0.008
4502,task_4502,480,489,9,480,1037,0.007
4503,task_4503,409,423,14,409,1217,0.012
4504,task_4504,428,438,10,428,638,0.005
4505,task_4505,290,302,12,290,1124,0.01
4506,task_4506,1113,1127,14,1113,1223,0.007
4507,task_4507,209,219,10,196,1394,0.007
4508,task_4508,723,732,9,723,1352,0.008
4509,task_4509,798,804,6,798,864,0.008
4510,task_4510,966,978,12,966,1162,0.013
4511,task_4511,840,850,10,834,1316,0.013
4512,task_4512,1323,1330,7,1323,1353,0.01
4513,task_4513,1314,1326,12,1314,1354,0.007
4514,task_4514,725,739,14,725,1312,0.014
4515,task_4515,684,692,8,684,804,0.007
4516,task_4516,148,160,12,148,1194,0.005
4517,task_4517,883,893,10,883,1090,0.012
4518,task_4518,323,337,14,323,353,0.01
4519,task_4519,510,522,12,510,896,0.006
4520,task_4520,193,204,11,192,797,0.006
4521,task_4521,234,240,6,233,1174,0.011
4522,task_4522,1023,1030,7,1023,1266,0.007
4523,task_4523,1224,1230,6,1224,1263,0.013
4524,task_4524,154,162,8,154,502,0.008
4525,task_4525,1341,1352,11,1341,1383,0.007
4526,task_4526,229,243,14,229,507,0.007
4527,task_4527,139,150,11,139,192,0.009
4528,task_4528,618,632,14,606,1260,0.009
4529,task_4529,1262,1273,11,1262,1323,0.007
4530,task_4530,13,25,12,13,177,0.007
4531,task_4531,184,194,10,184,856,0.011
4532,task_4532,524,535,11,524,714,0.005
4533,task_4533,966,979,13,966,1248,0.007
4534,task_4534,521,530,9,520,740,0.007
4535,task_4535,943,949,6,927,1323,0.006
4536,task_4536,1097,1106,9,1091,1398,0.005
4537,task_4537,765,776,11,764,1182,0.014
4538,task_4538,1136,1146,10,1113,1412,0.013
4539,task_4539,1193,1206,13,1193,1247,0.012
4540,task_4540,1329,1338,9,1269,1432,0.014
4541,task_4541,1028,1036,8,1028,1272,0.01
4542,task_4542,296,303,7,296,482,0.011
4543,task_4543,1080,1088,8,1079,1335,0.009
4544,task_4544,293,306,13,293,445,0.011
4545,task_4545,1017,1022,5,1017,1379,0.007
4546,task_4546,172,178,6,172,600,0.007
4547,task_4547,542,550,8,542,692,0.013
4548,task_4548,1315,1320,5,1312,1393,0.011
4549,task_4549,575,580,5,552,1354,0.009
4550,task_4550,790,803,13,789,1049,0.011
4551,task_4551,1020,1028,8,1020,1272,0.01
4552,task_4552,451,463,12,451,773,0.005
4553,task_4553,718,728,10,695,1344,0.008
4554,task_4554,1359,1367,8,1359,1390,0.006
4555,task_4555,438,451,13,438,465,0.012
4556,task_4556,1153,1166,13,1153,1357,0.005
4557,task_4557,782,796,14,782,898,0.005
4558,task_4558,452,463,11,452,1406,0.008
4559,task_4559,1138,1147,9,1088,1418,0.01
4560,task_4560,667,673,6,666,1096,0.009
4561,task_4561,543,548,5,542,995,0.014
4562,task_4562,736,750,14,736,1395,0.008
4563,task_4563,1390,1399,9,1390,1429,0.006
4564,task_4564,783,792,9,783,816,0.012
4565,task_4565,863,877,14,863,1242,0.01
4566,task_4566,296,307,11,295,852,0.014
4567,task_4567,730,739,9,730,1128,0.012
4568,task_4568,718,729,11,718,1301,0.005
4569,task_4569,801,811,10,801,1007,0.013
4570,task_4570,1039,1046,7,1039,1061,0.014
4571,task_4571,834,845,11,834,957,0.012
4572,task_4572,602,615,13,602,1150,0.005
4573,task_4573,468,476,8,468,507,0.013
4574,task_4574,56,65,9,56,1161,0.012
4575,task_4575,655,669,14,655,745,0.008
4576,task_4576,113,119,6,112,845,0.008
4577,task_4577,160,168,8,160,602,0.009
4578,task_4578,1204,1209,5,1204,1254,0.009
4579,task_4579,1064,1069,5,1060,1383,0.006
4580,task_4580,785,797,12,783,1049,0.014
4581,task_4581,1382,1390,8,1366,1439,0.005
4582,task_4582,267,272,5,267,1019,0.006
4583,task_4583,63,72,9,61,811,0.013
4584,task_4584,538,544,6,538,975,0.007
4585,task_4585,480,492,12,480,960,0.014
4586,task_4586,1327,1333,6,1283,1427,0.012
4587,task_4587,1257,1268,11,1256,1374,0.009
4588,task_4588,1307,1321,14,1305,1385,0.014
4589,task_4589,1175,1182,7,1167,1379,0.005
4590,task_4590,1382,1390,8,1368,1438,0.01
4591,task_4591,1025,1036,11,1025,1062,0.009
4592,task_4592,1287,1293,6,1287,1370,0.011
4593,task_4593,593,605,12,592,1421,0.01
4594,task_4594,677,686,9,676,1287,0.007
4595,task_4595,301,306,5,301,966,0.006
4596,task_4596,633,644,11,633,1296,0.013
4597,task_4597,1011,1019,8,1009,1409,0.008
4598,task_4598,1212,1224,12,1212,1245,0.005
4599,task_4599,16,29,13,16,474,0.005
4600,task_4600,902,907,5,902,1150,0.01
4601,task_4601,686,697,11,686,1214,0.007
4602,task_4602,520,534,14,519,563,0.005
4603,task_4603,5,15,10,5,777,0.014
4604,task_4604,1199,1211,12,1199,1226,0.009
4605,task_4605,1162,1167,5,1162,1325,0.008
4606,task_4606,393,398,5,393,1173,0.007
4607,task_4607,669,678,9,661,1314,0.007
4608,task_4608,868,881,13,868,1096,0.011
4609,task_4609,580,594,14,527,1382,0.006
4610,task_4610,1207,1217,10,1207,1368,0.005
4611,task_4611,557,564,7,557,897,0.005
4612,task_4612,1028,1036,8,1028,1301,0.006
4613,task_4613,1243,1250,7,1243,1360,0.009
4614,task_4614,650,663,13,650,798,0.008
4615,task_4615,517,529,12,517,1279,0.009
4616,task_4616,716,722,6,716,1102,0.006
4617,task_4617,315,321,6,314,1319,0.013
4618,task_4618,928,939,11,928,1297,0.011
4619,task_4619,985,992,7,985,1102,0.01
4620,task_4620,1120,1130,10,1120,1232,0.011
4621,task_4621,417,428,11,417,1393,0.009
4622,task_4622,588,597,9,580,1401,0.005
4623,task_4623,143,151,8,141,1089,0.006
4624,task_4624,883,889,6,879,1223,0.012
4625,task_4625,866,873,7,866,1142,0.011
4626,task_4626,932,940,8,932,1090,0.008
4627,task_4627,734,742,8,714,1416,0.009
4628,task_4628,155,168,13,144,1392,0.007
4629,task_4629,1336,1350,14,1333,1409,0.007
4630,task_4630,671,677,6,671,1168,0.014
4631,task_4631,601,613,12,601,832,0.012
4632,task_4632,673,679,6,672,723,0.009
4633,task_4633,1195,1202,7,1195,1239,0.014
4634,task_4634,1287,1294,7,1286,1388,0.011
4635,task_4635,508,513,5,481,1259,0.013
4636,task_4636,370,376,6,369,1075,0.007
4637,task_4637,96,104,8,94,916,0.012
4638,task_4638,649,660,11,649,700,0.012
4639,task_4639,678,688,10,649,1345,0.011
4640,task_4640,976,984,8,976,1116,0.013
4641,task_4641,751,760,9,745,1344,0.008
4642,task_4642,1325,1337,12,1324,1421,0.006
4643,task_4643,503,508,5,503,550,0.01
4644,task_4644,1180,1188,8,1151,1424,0.007
4645,task_4645,1376,1381,5,1376,1406,0.009
4646,task_4646,884,889,5,883,1252,0.011
4647,task_4647,934,941,7,934,1255,0.009
4648,task_4648,216,223,7,216,421,0.007
4649,task_4649,490,501,11,490,686,0.007
4650,task_4650,331,345,14,331,576,0.011
4651,task_4651,442,452,10,442,920,0.013
4652,task_4652,157,168,11,157,767,0.007
4653,task_4653,209,222,13,203,1387,0.01
4654,task_4654,1325,1338,13,1324,1413,0.007
4655,task_4655,778,786,8,778,1015,0.01
4656,task_4656,420,426,6,420,1176,0.013
4657,task_4657,582,594,12,582,955,0.005
4658,task_4658,1395,1401,6,1395,1415,0.014
4659,task_4659,631,638,7,629,1327,0.011
4660,task_4660,522,528,6,521,1259,0.011
4661,task_4661,867,874,7,866,1217,0.007
4662,task_4662,482,490,8,482,1153,0.013
4663,task_4663,1105,1118,13,1105,1299,0.007
4664,task_4664,1305,1312,7,1305,1346,0.007
4665,task_4665,364,372,8,364,610,0.008
4666,task_4666,841,849,8,841,1062,0.013
4667,task_4667,316,325,9,316,444,0.012
4668,task_4668,985,992,7,985,1288,0.009
4669,task_4669,352,363,11,351,727,0.008
4670,task_4670,493,507,14,493,970,0.012
4671,task_4671,692,706,14,690,1185,0.01
4672,task_4672,704,715,11,702,1170,0.008
4673,task_4673,659,668,9,659,805,0.005
4674,task_4674,1240,1246,6,1070,1432,0.012
4675,task_4675,805,813,8,797,1248,0.012
4676,task_4676,670,677,7,670,758,0.008
4677,task_4677,480,492,12,480,862,0.014
4678,task_4678,1089,1102,13,1089,1188,0.007
4679,task_4679,564,572,8,564,945,0.006
4680,task_4680,324,338,14,324,628,0.012
4681,task_4681,12,20,8,12,235,0.005
4682,task_4682,838,847,9,838,879,0.012
4683,task_4683,98,111,13,98,1434,0.007
4684,task_4684,609,618,9,607,1082,0.012
4685,task_4685,1097,1110,13,1092,1402,0.011
4686,task_4686,1219,1229,10,1088,1433,0.012
4687,task_4687,330,341,11,330,593,0.014
4688,task_4688,1117,1130,13,1080,1404,0.014
4689,task_4689,207,218,11,207,519,0.005
4690,task_4690,411,421,10,411,945,0.01
4691,task_4691,749,757,8,749,988,0.007
4692,task_4692,291,305,14,291,701,0.009
4693,task_4693,207,215,8,203,1287,0.008
4694,task_4694,486,497,11,485,1143,0.009
4695,task_4695,20,25,5,20,432,0.006
4696,task_4696,42,55,13,42,809,0.008
4697,task_4697,926,938,12,894,1409,0.005
4698,task_4698,1051,1062,11,1050,1379,0.006
4699,task_4699,891,897,6,891,1047,0.009
4700,task_4700,621,628,7,617,1338,0.008
4701,task_4701,1367,1375,8,1365,1409,0.005
4702,task_4702,45,59,14,45,876,0.011
4703,task_4703,66,78,12,66,243,0.011
4704,task_4704,277,289,12,277,685,0.006
4705,task_4705,656,667,11,656,738,0.013
4706,task_4706,1375,1383,8,1375,1427,0.013
4707,task_4707,628,638,10,612,1427,0.008
4708,task_4708,482,488,6,481,1169,0.008
4709,task_4709,865,873,8,865,961,0.012
4710,task_4710,623,634,11,621,1382,0.013
4711,task_4711,1357,1368,11,1355,1438,0.014
4712,task_4712,951,963,12,951,1289,0.01
4713,task_4713,1139,1147,8,1139,1203,0.005
4714,task_4714,669,681,12,669,1187,0.005
4715,task_4715,105,110,5,105,709,0.007
4716,task_4716,817,830,13,794,1348,0.007
4717,task_4717,1112,1124,12,1112,1184,0.013
4718,task_4718,647,652,5,647,1282,0.007
4719,task_4719,1289,1297,8,1289,1342,0.011
4720,task_4720,809,819,10,797,1291,0.006
4721,task_4721,235,247,12,235,690,0.005
4722,task_4722,474,486,12,474,899,0.005
4723,task_4723,401,415,14,399,1288,0.006
4724,task_4724,600,606,6,597,1416,0.013
4725,task_4725,1150,1157,7,1150,1331,0.011
4726,task_4726,946,958,12,946,974,0.006
4727,task_4727,1066,1075,9,1029,1407,0.009
4728,task_4728,68,75,7,68,307,0.012
4729,task_4729,1286,1299,13,1280,1353,0.008
4730,task_4730,1135,1142,7,1134,1225,0.008
4731,task_4731,1189,1203,14,1189,1266,0.011
4732,task_4732,42,52,10,42,970,0.01
4733,task_4733,247,259,12,247,291,0.005
4734,task_4734,171,183,12,171,618,0.01
4735,task_4735,1058,1068,10,1058,1094,0.014
4736,task_4736,1394,1404,10,1394,1416,0.011
4737,task_4737,325,335,10,325,554,0.008
4738,task_4738,750,755,5,749,1101,0.01
4739,task_4739,811,823,12,810,1126,0.014
4740,task_4740,1021,1031,10,1021,1226,0.014
4741,task_4741,1138,1148,10,1110,1419,0.01
4742,task_4742,885,895,10,881,1268,0.014
4743,task_4743,772,777,5,772,824,0.011
4744,task_4744,1108,1118,10,1107,1288,0.01
4745,task_4745,474,479,5,474,509,0.01
4746,task_4746,307,314,7,297,1350,0.013
4747,task_4747,354,368,14,354,454,0.013
4748,task_4748,157,170,13,157,839,0.011
4749,task_4749,1255,1260,5,1034,1434,0.007
4750,task_4750,745,751,6,745,962,0.012
4751,task_4751,1020,1033,13,808,1427,0.01
4752,task_4752,1339,1351,12,1333,1422,0.011
4753,task_4753,173,182,9,172,1404,0.009
4754,task_4754,1067,1074,7,1067,1283,0.009
4755,task_4755,668,673,5,667,1120,0.011
4756,task_4756,1080,1093,13,1080,1367,0.012
4757,task_4757,1313,1327,14,1313,1345,0.01
4758,task_4758,621,629,8,609,1330,0.009
4759,task_4759,797,805,8,797,1025,0.008
4760,task_4760,975,983,8,779,1414,0.011
4761,task_4761,307,317,10,305,1301,0.006
4762,task_4762,1245,1254,9,1245,1310,0.014
4763,task_4763,1120,1132,12,1119,1244,0.005
4764,task_4764,417,426,9,417,1051,0.013
4765,task_4765,1249,1261,12,1249,1310,0.01
4766,task_4766,215,224,9,215,950,0.005
4767,task_4767,678,685,7,663,1354,0.008
4768,task_4768,634,648,14,634,1044,0.006
4769,task_4769,1166,1178,12,1166,1401,0.009
4770,task_4770,986,999,13,826,1422,0.008
4771,task_4771,136,144,8,136,518,0.01
4772,task_4772,350,363,13,350,708,0.013
4773,task_4773,1091,1101,10,1091,1255,0.005
4774,task_4774,1015,1020,5,1015,1153,0.008
4775,task_4775,10,15,5,10,47,0.011
4776,task_4776,96,104,8,94,874,0.013
4777,task_4777,1004,1016,12,1003,1258,0.007
4778,task_4778,530,535,5,524,1338,0.007
4779,task_4779,658,664,6,657,819,0.013
4780,task_4780,25,32,7,25,728,0.013
4781,task_4781,940,950,10,940,1046,0.006
4782,task_4782,731,745,14,716,1415,0.01
4783,task_4783,1127,1137,10,1125,1275,0.007
4784,task_4784,568,582,14,556,1325,0.011
4785,task_4785,1091,1105,14,1091,1267,0.01
4786,task_4786,1140,1151,11,1097,1426,0.007
4787,task_4787,434,442,8,434,819,0.012
4788,task_4788,223,229,6,223,373,0.005
4789,task_4789,651,664,13,651,878,0.01
4790,task_4790,262,269,7,262,760,0.007
4791,task_4791,323,332,9,323,815,0.009
4792,task_4792,541,548,7,536,1237,0.005
4793,task_4793,114,122,8,114,639,0.012
4794,task_4794,989,1001,12,989,1336,0.008
4795,task_4795,1181,1189,8,1181,1359,0.006
4796,task_4796,761,773,12,761,875,0.006
4797,task_4797,1039,1050,11,1038,1306,0.01
4798,task_4798,140,152,12,140,844,0.011
4799,task_4799,133,147,14,130,1277,0.013
4800,task_4800,401,414,13,397,1247,0.013
4801,task_4801,490,502,12,489,938,0.008
4802,task_4802,1200,1213,13,1200,1319,0.006
4803,task_4803,1005,1012,7,1003,1305,0.005
4804,task_4804,926,937,11,825,1403,0.013
4805,task_4805,1073,1087,14,1071,1391,0.013
4806,task_4806,1240,1247,7,1240,1272,0.009
4807,task_4807,821,827,6,821,968,0.011
4808,task_4808,900,914,14,900,1028,0.011
4809,task_4809,849,863,14,836,1363,0.01
4810,task_4810,900,910,10,900,922,0.011
4811,task_4811,313,327,14,313,780,0.013
4812,task_4812,462,472,10,462,1253,0.011
4813,task_4813,978,987,9,978,1044,0.012
4814,task_4814,188,202,14,188,852,0.009
4815,task_4815,422,428,6,422,872,0.01
4816,task_4816,1064,1077,13,1061,1383,0.008
4817,task_4817,779,790,11,779,1196,0.013
4818,task_4818,612,618,6,610,1131,0.006
4819,task_4819,515,522,7,515,726,0.005
4820,task_4820,11,24,13,11,945,0.013
4821,task_4821,764,773,9,764,881,0.01
4822,task_4822,439,452,13,439,792,0.005
4823,task_4823,850,859,9,850,922,0.01
4824,task_4824,1023,1036,13,1023,1075,0.006
4825,task_4825,1398,1405,7,1398,1429,0.009
4826,task_4826,633,642,9,633,1097,0.005
4827,task_4827,810,819,9,810,1085,0.007
4828,task_4828,508,521,13,508,1267,0.011
4829,task_4829,529,537,8,512,1331,0.009
4830,task_4830,1201,1208,7,1201,1380,0.01
4831,task_4831,1213,1222,9,1213,1295,0.013
4832,task_4832,786,791,5,786,979,0.005
4833,task_4833,111,120,9,107,1117,0.013
4834,task_4834,922,934,12,922,1207,0.01
4835,task_4835,187,196,9,187,537,0.011
4836,task_4836,1041,1054,13,1041,1129,0.006
4837,task_4837,734,747,13,709,1426,0.005
4838,task_4838,335,345,10,335,654,0.009
4839,task_4839,878,889,11,878,1342,0.009
4840,task_4840,1075,1085,10,1052,1422,0.009
4841,task_4841,541,555,14,541,1325,0.012
4842,task_4842,523,529,6,523,1048,0.012
4843,task_4843,429,434,5,429,712,0.013
4844,task_4844,1149,1158,9,1149,1168,0.005
4845,task_4845,270,278,8,269,1006,0.013
4846,task_4846,869,877,8,869,928,0.014
4847,task_4847,185,199,14,185,963,0.005
4848,task_4848,325,334,9,325,392,0.01
4849,task_4849,713,724,11,712,773,0.011
4850,task_4850,970,977,7,970,1021,0.009
4851,task_4851,509,515,6,485,1278,0.01
4852,task_4852,179,192,13,179,642,0.014
4853,task_4853,1185,1199,14,1185,1259,0.007
4854,task_4854,953,963,10,953,1075,0.012
4855,task_4855,413,422,9,413,582,0.013
4856,task_4856,34,44,10,34,207,0.005
4857,task_4857,127,137,10,127,562,0.005
4858,task_4858,1354,1361,7,1353,1430,0.012
4859,task_4859,574,580,6,574,1135,0.014
4860,task_4860,1003,1011,8,1003,1241,0.014
4861,task_4861,1250,1255,5,1250,1322,0.008
4862,task_4862,250,259,9,250,850,0.006
4863,task_4863,644,650,6,644,694,0.006
4864,task_4864,963,972,9,963,1182,0.007
4865,task_4865,947,961,14,947,1338,0.005
4866,task_4866,1347,1353,6,1345,1406,0.009
4867,task_4867,363,370,7,358,1225,0.01
4868,task_4868,1310,1316,6,1309,1397,0.008
4869,task_4869,446,453,7,446,729,0.011
4870,task_4870,138,143,5,138,526,0.009
4871,task_4871,654,667,13,654,1054,0.012
4872,task_4872,50,56,6,50,651,0.011
4873,task_4873,1226,1240,14,1226,1256,0.006
4874,task_4874,289,297,8,289,832,0.013
4875,task_4875,1227,1238,11,1227,1374,0.005
4876,task_4876,66,78,12,66,940,0.008
4877,task_4877,411,422,11,411,1204,0.011
4878,task_4878,526,532,6,526,1125,0.008
4879,task_4879,448,455,7,448,1196,0.011
4880,task_4880,1266,1277,11,1266,1303,0.013
4881,task_4881,1043,1048,5,1042,1238,0.008
4882,task_4882,792,801,9,792,1208,0.008
4883,task_4883,1158,1167,9,1154,1387,0.009
4884,task_4884,1251,1262,11,1251,1277,0.013
4885,task_4885,217,229,12,214,1292,0.005
4886,task_4886,1091,1097,6,1091,1149,0.011
4887,task_4887,1090,1097,7,1090,1145,0.008
4888,task_4888,258,264,6,258,935,0.01
4889,task_4889,813,819,6,808,1308,0.009
4890,task_4890,1157,1162,5,1157,1190,0.006
4891,task_4891,483,493,10,483,990,0.013
4892,task_4892,272,280,8,272,1325,0.008
4893,task_4893,43,51,8,43,1022,0.01
4894,task_4894,143,151,8,140,1062,0.009
4895,task_4895,286,293,7,286,802,0.011
4896,task_4896,1181,1195,14,1080,1431,0.013
4897,task_4897,1255,1268,13,1255,1374,0.01
4898,task_4898,607,617,10,607,633,0.011
4899,task_4899,277,283,6,277,819,0.006
4900,task_4900,862,868,6,862,1040,0.006
4901,task_4901,837,846,9,834,1176,0.011
4902,task_4902,1328,1339,11,1322,1432,0.011
4903,task_4903,955,965,10,955,1250,0.007
4904,task_4904,350,356,6,350,788,0.011
4905,task_4905,905,912,7,905,1208,0.013
4906,task_4906,1318,1324,6,1316,1382,0.008
4907,task_4907,959,971,12,958,1231,0.012
4908,task_4908,505,515,10,505,930,0.013
4909,task_4909,437,445,8,437,1068,0.01
4910,task_4910,907,921,14,907,1346,0.007
4911,task_4911,1033,1044,11,1033,1084,0.007
4912,task_4912,640,652,12,640,1185,0.012
4913,task_4913,568,578,10,559,1289,0.01
4914,task_4914,1252,1265,13,1252,1285,0.011
4915,task_4915,724,733,9,724,837,0.011
4916,task_4916,1188,1197,9,1188,1318,0.014
4917,task_4917,1343,1355,12,1343,1400,0.007
4918,task_4918,1255,1264,9,1249,1423,0.011
4919,task_4919,479,489,10,479,1256,0.01
4920,task_4920,852,860,8,852,919,0.011
4921,task_4921,1091,1102,11,1091,1198,0.006
4922,task_4922,293,300,7,293,1000,0.013
4923,task_4923,436,449,13,436,834,0.012
4924,task_4924,925,936,11,919,1391,0.006
4925,task_4925,675,685,10,674,1028,0.014
4926,task_4926,248,262,14,248,988,0.012
4927,task_4927,1302,1310,8,1273,1425,0.013
4928,task_4928,1101,1107,6,1098,1351,0.011
4929,task_4929,1286,1300,14,1282,1362,0.01
4930,task_4930,231,242,11,205,1422,0.008
4931,task_4931,1264,1275,11,1264,1367,0.007
4932,task_4932,1053,1065,12,1052,1273,0.007
4933,task_4933,623,632,9,623,687,0.011
4934,task_4934,1112,1122,10,1112,1223,0.005
4935,task_4935,1110,1124,14,1108,1307,0.013
4936,task_4936,909,915,6,900,1349,0.009
4937,task_4937,662,669,7,662,681,0.011
4938,task_4938,1371,1378,7,1369,1430,0.005
4939,task_4939,1147,1160,13,1147,1223,0.013
4940,task_4940,1102,1114,12,1102,1223,0.01
4941,task_4941,1007,1013,6,1007,1313,0.012
4942,task_4942,726,734,8,718,1394,0.008
4943,task_4943,701,715,14,701,760,0.007
4944,task_4944,717,727,10,717,954,0.013
4945,task_4945,134,148,14,134,760,0.012
4946,task_4946,743,751,8,743,1343,0.008
4947,task_4947,1116,1121,5,1115,1248,0.008
4948,task_4948,347,357,10,347,1279,0.013
4949,task_4949,1362,1367,5,1341,1436,0.009
4950,task_4950,806,812,6,800,1259,0.005
4951,task_4951,655,664,9,655,1039,0.014
4952,task_4952,677,686,9,677,1123,0.013
4953,task_4953,227,239,12,221,1403,0.008
4954,task_4954,605,618,13,604,1188,0.006
4955,task_4955,138,145,7,138,411,0.014
4956,task_4956,49,60,11,49,976,0.013
4957,task_4957,638,646,8,638,1398,0.006
4958,task_4958,827,840,13,821,1371,0.008
4959,task_4959,69,81,12,69,750,0.012
4960,task_4960,361,371,10,360,682,0.008
4961,task_4961,805,811,6,805,1009,0.014
4962,task_4962,907,916,9,907,1030,0.009
4963,task_4963,1378,1390,12,1378,1412,0.009
4964,task_4964,612,624,12,612,851,0.008
4965,task_4965,376,388,12,360,1390,0.007
4966,task_4966,1206,1212,6,1205,1381,0.007
4967,task_4967,575,589,14,575,731,0.013
4968,task_4968,741,753,12,741,1251,0.007
4969,task_4969,27,36,9,26,1200,0.014
4970,task_4970,499,506,7,499,643,0.008
4971,task_4971,957,969,12,957,1036,0.008
4972,task_4972,1090,1103,13,1090,1192,0.005
4973,task_4973,197,204,7,197,703,0.01
4974,task_4974,517,527,10,517,1259,0.011
4975,task_4975,1374,1382,8,1374,1419,0.011
4976,task_4976,1136,1142,6,1135,1337,0.014
4977,task_4977,656,663,7,651,1202,0.008
4978,task_4978,261,267,6,261,1117,0.006
4979,task_4979,1165,1171,6,1165,1357,0.009
4980,task_4980,681,693,12,680,1096,0.006
4981,task_4981,1209,1222,13,1193,1431,0.011
4982,task_4982,1076,1083,7,1076,1109,0.011
4983,task_4983,605,618,13,604,1299,0.005
4984,task_4984,728,737,9,717,1398,0.011
4985,task_4985,365,372,7,365,1082,0.006
4986,task_4986,1244,1254,10,1244,1284,0.014
4987,task_4987,5,12,7,5,1033,0.011
4988,task_4988,1143,1156,13,1143,1394,0.009
4989,task_4989,1009,1022,13,1009,1181,0.007
4990,task_4990,719,731,12,705,1357,0.011
4991,task_4991,273,279,6,273,315,0.012
4992,task_4992,913,921,8,913,1307,0.005
4993,task_4993,1036,1047,11,1032,1260,0.011
4994,task_4994,265,274,9,265,1166,0.009
4995,task_4995,361,367,6,361,925,0.013
4996,task_4996,1045,1053,8,1040,1353,0.011
4997,task_4997,432,437,5,432,1285,0.008
4998,task_4998,327,338,11,327,1162,0.008
4999,task_4999,1011,1018,7,1008,1310,0.006
5000,task_5000,945,956,11,945,1205,0.005
5001,task_5001,1042,1056,14,1040,1213,0.01
5002,task_5002,243,257,14,243,1436,0.005
5003,task_5003,1321,1328,7,1281,1426,0.011
5004,task_5004,995,1001,6,995,1338,0.011
5005,task_5005,1233,1246,13,953,1438,0.013
5006,task_5006,597,602,5,597,1113,0.008
5007,task_5007,1117,1124,7,1115,1285,0.011
5008,task_5008,324,338,14,324,599,0.008
5009,task_5009,1153,1159,6,1153,1349,0.008
5010,task_5010,1352,1365,13,1352,1413,0.006
5011,task_5011,704,716,12,702,1129,0.01
5012,task_5012,740,751,11,740,890,0.013
5013,task_5013,394,405,11,394,1135,0.013
5014,task_5014,191,204,13,191,388,0.013
5015,task_5015,9,23,14,9,723,0.01
5016,task_5016,495,508,13,495,871,0.01
5017,task_5017,330,340,10,330,748,0.006
5018,task_5018,753,761,8,753,1099,0.008
5019,task_5019,997,1005,8,991,1361,0.014
5020,task_5020,465,473,8,465,891,0.009
5021,task_5021,943,948,5,941,1304,0.005
5022,task_5022,161,171,10,161,1295,0.014
5023,task_5023,536,545,9,535,934,0.005
5024,task_5024,202,214,12,202,516,0.008
5025,task_5025,268,278,10,268,630,0.013
5026,task_5026,1199,1207,8,1199,1244,0.006
5027,task_5027,444,453,9,444,1149,0.014
5028,task_5028,809,819,10,799,1278,0.011
5029,task_5029,801,806,5,800,1124,0.011
5030,task_5030,242,253,11,242,973,0.007
5031,task_5031,1240,1245,5,1240,1288,0.006
5032,task_5032,759,772,13,759,1233,0.006
5033,task_5033,1105,1111,6,1101,1372,0.012
5034,task_5034,906,914,8,906,1274,0.011
5035,task_5035,836,847,11,834,1107,0.014
5036,task_5036,155,168,13,130,1439,0.01
5037,task_5037,267,275,8,267,957,0.007
5038,task_5038,332,344,12,332,929,0.005
5039,task_5039,771,779,8,761,1433,0.011
5040,task_5040,1289,1295,6,1289,1325,0.01
5041,task_5041,641,654,13,639,1250,0.009
5042,task_5042,228,239,11,228,327,0.013
5043,task_5043,1028,1042,14,1028,1219,0.01
5044,task_5044,1059,1067,8,1059,1195,0.007
5045,task_5045,159,171,12,159,548,0.01
5046,task_5046,1401,1406,5,1396,1438,0.006
5047,task_5047,393,400,7,392,656,0.014
5048,task_5048,642,649,7,642,1313,0.01
5049,task_5049,77,86,9,77,961,0.007
5050,task_5050,847,858,11,842,1270,0.006
5051,task_5051,742,750,8,741,1293,0.007
5052,task_5052,338,350,12,335,1234,0.012
5053,task_5053,865,875,10,864,1010,0.005
5054,task_5054,4,16,12,4,446,0.014
5055,task_5055,786,797,11,786,996,0.013
5056,task_5056,1379,1388,9,1379,1417,0.006
5057,task_5057,1273,1281,8,1271,1403,0.011
5058,task_5058,442,453,11,442,567,0.009
5059,task_5059,250,261,11,250,989,0.012
5060,task_5060,134,139,5,134,1202,0.005
5061,task_5061,208,213,5,208,854,0.009
5062,task_5062,1401,1407,6,1397,1439,0.008
5063,task_5063,995,1006,11,995,1191,0.014
5064,task_5064,1177,1188,11,1177,1373,0.013
5065,task_5065,1314,1325,11,1314,1369,0.013
5066,task_5066,1319,1328,9,1307,1421,0.009
5067,task_5067,527,538,11,527,978,0.007
5068,task_5068,1224,1234,10,1224,1433,0.014
5069,task_5069,151,163,12,151,823,0.006
5070,task_5070,623,633,10,623,1362,0.005
5071,task_5071,1373,1379,6,1373,1406,0.01
5072,task_5072,808,817,9,807,994,0.013
5073,task_5073,287,294,7,287,897,0.014
5074,task_5074,126,131,5,126,548,0.014
5075,task_5075,541,552,11,536,1301,0.005
5076,task_5076,685,694,9,651,1371,0.013
5077,task_5077,357,367,10,357,1207,0.008
5078,task_5078,648,657,9,648,733,0.013
5079,task_5079,1240,1252,12,1240,1326,0.011
5080,task_5080,227,240,13,204,1420,0.009
5081,task_5081,516,530,14,516,1151,0.012
5082,task_5082,716,725,9,716,749,0.011
5083,task_5083,592,605,13,590,1343,0.005
5084,task_5084,761,775,14,761,850,0.008
5085,task_5085,1277,1286,9,1274,1374,0.011
5086,task_5086,367,376,9,367,1195,0.013
5087,task_5087,976,982,6,854,1412,0.014
5088,task_5088,148,162,14,148,313,0.011
5089,task_5089,390,400,10,390,1234,0.011
5090,task_5090,97,104,7,97,885,0.011
5091,task_5091,1127,1138,11,1127,1173,0.007
5092,task_5092,1206,1213,7,1206,1322,0.008
5093,task_5093,566,580,14,566,638,0.009
5094,task_5094,501,509,8,501,784,0.008
5095,task_5095,406,415,9,405,1278,0.014
5096,task_5096,1158,1168,10,1158,1296,0.007
5097,task_5097,775,783,8,594,1436,0.012
5098,task_5098,1097,1108,11,1097,1121,0.009
5099,task_5099,168,175,7,166,1149,0.005
5100,task_5100,1260,1267,7,1260,1342,0.012
5101,task_5101,1053,1065,12,1053,1133,0.008
5102,task_5102,1272,1277,5,1272,1358,0.014
5103,task_5103,1377,1387,10,1373,1429,0.013
5104,task_5104,29,36,7,29,327,0.011
5105,task_5105,866,878,12,865,1132,0.01
5106,task_5106,155,160,5,140,1434,0.014
5107,task_5107,691,704,13,690,1067,0.009
5108,task_5108,643,656,13,643,985,0.008
5109,task_5109,1150,1158,8,1150,1312,0.013
5110,task_5110,1342,1355,13,1342,1367,0.013
5111,task_5111,1297,1309,12,1297,1357,0.012
5112,task_5112,45,53,8,45,1297,0.011
5113,task_5113,411,418,7,411,1203,0.01
5114,task_5114,21,34,13,21,456,0.014
5115,task_5115,125,138,13,121,1052,0.011
5116,task_5116,364,376,12,364,713,0.006
5117,task_5117,571,583,12,571,1318,0.01
5118,task_5118,1270,1276,6,1270,1351,0.005
5119,task_5119,715,726,11,714,1241,0.012
5120,task_5120,302,309,7,302,1040,0.005
5121,task_5121,1155,1166,11,1155,1178,0.007
5122,task_5122,1394,1406,12,1394,1422,0.005
5123,task_5123,759,766,7,759,1416,0.007
5124,task_5124,1321,1328,7,1321,1340,0.012
5125,task_5125,755,765,10,755,1030,0.009
5126,task_5126,1035,1043,8,1035,1088,0.009
5127,task_5127,1248,1260,12,1248,1324,0.011
5128,task_5128,339,350,11,339,470,0.013
5129,task_5129,1096,1107,11,1096,1386,0.01
5130,task_5130,501,514,13,501,1051,0.012
5131,task_5131,195,203,8,195,887,0.011
5132,task_5132,95,100,5,95,288,0.006
5133,task_5133,634,640,6,633,1377,0.008
5134,task_5134,86,96,10,86,366,0.008
5135,task_5135,1116,1124,8,1116,1182,0.006
5136,task_5136,1326,1334,8,1279,1428,0.014
5137,task_5137,33,38,5,33,115,0.013
5138,task_5138,1242,1248,6,806,1434,0.005
5139,task_5139,291,298,7,291,1282,0.008
5140,task_5140,448,459,11,448,552,0.01
5141,task_5141,877,888,11,877,1257,0.006
5142,task_5142,421,429,8,420,1429,0.008
5143,task_5143,358,370,12,358,907,0.007
5144,task_5144,168,180,12,165,1421,0.011
5145,task_5145,1,13,12,1,373,0.012
5146,task_5146,1339,1351,12,1336,1430,0.012
5147,task_5147,767,781,14,767,1054,0.005
5148,task_5148,1047,1056,9,1045,1367,0.006
5149,task_5149,1165,1179,14,1159,1400,0.011
5150,task_5150,253,262,9,253,446,0.01
5151,task_5151,715,721,6,715,900,0.005
5152,task_5152,1260,1272,12,1260,1312,0.009
5153,task_5153,730,738,8,730,1286,0.011
5154,task_5154,149,154,5,149,1019,0.005
5155,task_5155,1227,1240,13,1227,1402,0.008
5156,task_5156,1051,1061,10,1040,1372,0.009
5157,task_5157,1352,1362,10,1325,1437,0.008
5158,task_5158,965,979,14,964,1138,0.01
5159,task_5159,907,916,9,907,1185,0.006
5160,task_5160,1225,1230,5,1225,1303,0.01
5161,task_5161,972,984,12,972,1256,0.011
5162,task_5162,906,912,6,906,1323,0.006
5163,task_5163,929,938,9,929,1038,0.009
5164,task_5164,867,875,8,865,1196,0.01
5165,task_5165,548,560,12,548,1086,0.009
5166,task_5166,962,974,12,962,1036,0.008
5167,task_5167,43,57,14,43,1318,0.007
5168,task_5168,123,134,11,123,605,0.006
5169,task_5169,84,98,14,84,739,0.012
5170,task_5170,1311,1317,6,1309,1402,0.008
5171,task_5171,827,836,9,820,1344,0.006
5172,task_5172,591,601,10,591,1135,0.005
5173,task_5173,1090,1097,7,1089,1185,0.014
5174,task_5174,606,618,12,606,873,0.011
5175,task_5175,165,177,12,165,528,0.013
5176,task_5176,1087,1096,9,1087,1180,0.014
5177,task_5177,412,424,12,412,965,0.014
5178,task_5178,321,330,9,321,650,0.007
5179,task_5179,383,394,11,383,589,0.01
5180,task_5180,588,598,10,588,712,0.005
5181,task_5181,59,67,8,59,955,0.014
5182,task_5182,128,138,10,128,257,0.006
5183,task_5183,266,272,6,266,1154,0.007
5184,task_5184,1261,1275,14,1261,1292,0.012
5185,task_5185,888,902,14,888,1143,0.005
5186,task_5186,194,200,6,193,1087,0.012
5187,task_5187,947,959,12,945,1319,0.012
5188,task_5188,976,985,9,976,1408,0.01
5189,task_5189,240,250,10,240,1218,0.007
5190,task_5190,1153,1160,7,1153,1411,0.014
5191,task_5191,1264,1277,13,1264,1301,0.008
5192,task_5192,422,427,5,422,821,0.012
5193,task_5193,279,291,12,279,875,0.009
5194,task_5194,749,762,13,747,962,0.011
5195,task_5195,1262,1273,11,1258,1430,0.005
5196,task_5196,970,982,12,966,1356,0.012
5197,task_5197,24,35,11,19,1179,0.011
5198,task_5198,1393,1402,9,1393,1424,0.014
5199,task_5199,237,242,5,237,471,0.008
5200,task_5200,255,263,8,255,1185,0.008
5201,task_5201,980,990,10,980,1024,0.006
5202,task_5202,36,44,8,36,656,0.008
5203,task_5203,999,1012,13,999,1333,0.006
5204,task_5204,1302,1315,13,1302,1358,0.005
5205,task_5205,1067,1076,9,1067,1294,0.008
5206,task_5206,861,872,11,799,1383,0.012
5207,task_5207,53,58,5,53,91,0.009
5208,task_5208,1116,1126,10,1116,1220,0.013
5209,task_5209,648,657,9,648,967,0.006
5210,task_5210,1338,1346,8,1334,1414,0.01
5211,task_5211,1369,1374,5,1369,1386,0.013
5212,task_5212,952,957,5,952,1120,0.008
5213,task_5213,593,605,12,589,1413,0.01
5214,task_5214,1200,1212,12,1200,1378,0.007
5215,task_5215,792,800,8,781,1260,0.008
5216,task_5216,1384,1396,12,1384,1437,0.007
5217,task_5217,433,442,9,433,503,0.009
5218,task_5218,241,253,12,241,354,0.013
5219,task_5219,413,421,8,413,737,0.008
5220,task_5220,1088,1094,6,1084,1370,0.013
5221,task_5221,1025,1039,14,1025,1114,0.012
5222,task_5222,192,204,12,192,609,0.012
5223,task_5223,1011,1020,9,1011,1234,0.005
5224,task_5224,541,553,12,536,1279,0.008
5225,task_5225,704,713,9,701,1141,0.005
5226,task_5226,470,481,11,470,814,0.007
5227,task_5227,453,461,8,453,1324,0.007
5228,task_5228,878,892,14,781,1404,0.005
5229,task_5229,487,495,8,482,1174,0.01
5230,task_5230,1105,1118,13,1105,1343,0.01
5231,task_5231,12,19,7,12,350,0.009
5232,task_5232,1144,1156,12,1144,1219,0.008
5233,task_5233,249,262,13,249,1371,0.014
5234,task_5234,39,48,9,39,349,0.013
5235,task_5235,1368,1373,5,1367,1417,0.012
5236,task_5236,606,615,9,606,946,0.014
5237,task_5237,940,947,7,940,1008,0.012
5238,task_5238,272,280,8,269,1404,0.014
5239,task_5239,706,718,12,706,1106,0.014
5240,task_5240,1349,1360,11,1345,1421,0.007
5241,task_5241,604,614,10,604,1100,0.005
5242,task_5242,792,800,8,788,1189,0.006
5243,task_5243,1388,1395,7,1381,1439,0.011
5244,task_5244,693,707,14,693,841,0.007
5245,task_5245,1349,1358,9,1349,1431,0.012
5246,task_5246,1264,1270,6,1264,1350,0.006
5247,task_5247,471,485,14,471,497,0.009
5248,task_5248,615,623,8,611,1183,0.01
5249,task_5249,488,493,5,488,732,0.014
5250,task_5250,614,620,6,609,1141,0.011
5251,task_5251,381,390,9,380,694,0.014
5252,task_5252,1188,1201,13,1186,1328,0.014
5253,task_5253,330,340,10,330,609,0.005
5254,task_5254,1068,1075,7,1036,1409,0.007
5255,task_5255,160,173,13,160,1401,0.01
5256,task_5256,998,1004,6,998,1127,0.013
5257,task_5257,850,856,6,850,964,0.007
5258,task_5258,939,948,9,933,1290,0.005
5259,task_5259,240,249,9,240,507,0.008
5260,task_5260,1293,1299,6,1265,1413,0.005
5261,task_5261,1342,1352,10,1340,1429,0.013
5262,task_5262,1138,1147,9,1138,1313,0.009
5263,task_5263,214,221,7,210,1169,0.008
5264,task_5264,297,309,12,297,1072,0.011
5265,task_5265,16,25,9,16,597,0.012
5266,task_5266,714,719,5,714,877,0.011
5267,task_5267,859,868,9,858,1218,0.006
5268,task_5268,924,933,9,924,999,0.013
5269,task_5269,1031,1040,9,1031,1230,0.007
5270,task_5270,756,770,14,756,914,0.012
5271,task_5271,527,541,14,527,959,0.013
5272,task_5272,384,394,10,381,1108,0.012
5273,task_5273,489,496,7,489,585,0.01
5274,task_5274,0,12,12,0,1295,0.011
5275,task_5275,284,290,6,284,1036,0.013
5276,task_5276,1175,1184,9,1171,1384,0.01
5277,task_5277,953,963,10,952,1345,0.013
5278,task_5278,80,91,11,80,1158,0.008
5279,task_5279,1100,1107,7,1100,1183,0.007
5280,task_5280,664,678,14,660,1172,0.014
5281,task_5281,431,439,8,431,981,0.005
5282,task_5282,1219,1229,10,1219,1300,0.014
5283,task_5283,1036,1043,7,1034,1257,0.008
5284,task_5284,325,335,10,325,1287,0.01
5285,task_5285,590,597,7,590,700,0.009
5286,task_5286,668,673,5,668,857,0.008
5287,task_5287,569,582,13,569,752,0.007
5288,task_5288,1254,1260,6,1254,1368,0.005
5289,task_5289,218,227,9,217,1327,0.013
5290,task_5290,20,32,12,20,513,0.012
5291,task_5291,300,312,12,300,1020,0.013
5292,task_5292,343,351,8,343,727,0.011
5293,task_5293,580,587,7,580,1084,0.009
5294,task_5294,849,861,12,830,1355,0.013
5295,task_5295,515,529,14,512,1245,0.005
5296,task_5296,1288,1296,8,1288,1329,0.012
5297,task_5297,972,980,8,972,1063,0.007
5298,task_5298,1102,1116,14,1102,1178,0.013
5299,task_5299,706,719,13,706,1068,0.011
5300,task_5300,343,354,11,343,939,0.014
5301,task_5301,591,599,8,590,1130,0.011
5302,task_5302,283,293,10,282,1219,0.008
5303,task_5303,91,103,12,91,147,0.01
5304,task_5304,161,175,14,161,467,0.007
5305,task_5305,1100,1112,12,1100,1165,0.011
5306,task_5306,439,446,7,439,1170,0.008
5307,task_5307,90,96,6,90,486,0.01
5308,task_5308,1318,1331,13,1317,1393,0.009
5309,task_5309,264,274,10,264,520,0.013
5310,task_5310,1109,1122,13,1109,1139,0.014
5311,task_5311,1243,1251,8,1243,1400,0.005
5312,task_5312,1301,1311,10,1301,1355,0.01
5313,task_5313,929,942,13,929,978,0.009
5314,task_5314,277,287,10,277,477,0.008
5315,task_5315,1073,1087,14,1073,1364,0.006
5316,task_5316,916,925,9,915,1355,0.01
5317,task_5317,0,7,7,0,1204,0.007
5318,task_5318,638,647,9,637,993,0.005
5319,task_5319,847,855,8,847,935,0.011
5320,task_5320,479,491,12,479,1031,0.006
5321,task_5321,718,723,5,717,1079,0.014
5322,task_5322,1114,1128,14,1114,1267,0.009
5323,task_5323,1257,1263,6,1256,1387,0.013
5324,task_5324,827,840,13,826,1284,0.009
5325,task_5325,459,464,5,459,642,0.008
5326,task_5326,1068,1082,14,1068,1352,0.009
5327,task_5327,553,562,9,553,1145,0.008
5328,task_5328,430,436,6,430,1291,0.009
5329,task_5329,904,916,12,904,1092,0.009
5330,task_5330,983,997,14,983,1057,0.012
5331,task_5331,1113,1121,8,1113,1255,0.005
5332,task_5332,984,995,11,984,1186,0.006
5333,task_5333,1203,1210,7,1203,1403,0.005
5334,task_5334,1310,1317,7,1310,1343,0.006
5335,task_5335,538,544,6,538,685,0.014
5336,task_5336,481,490,9,481,994,0.013
5337,task_5337,889,897,8,888,1215,0.012
5338,task_5338,979,985,6,979,1380,0.006
5339,task_5339,508,518,10,508,990,0.005
5340,task_5340,593,606,13,567,1417,0.008
5341,task_5341,962,967,5,947,1394,0.008
5342,task_5342,1103,1108,5,1103,1181,0.01
5343,task_5343,938,951,13,934,1276,0.014
5344,task_5344,201,208,7,193,1310,0.01
5345,task_5345,123,136,13,123,524,0.01
5346,task_5346,659,666,7,659,724,0.009
5347,task_5347,436,447,11,436,1332,0.007
5348,task_5348,976,981,5,976,1219,0.011
5349,task_5349,1358,1371,13,1358,1396,0.01
5350,task_5350,77,85,8,77,434,0.009
5351,task_5351,587,599,12,587,1343,0.009
5352,task_5352,1143,1153,10,1141,1398,0.013
5353,task_5353,27,37,10,26,1067,0.008
5354,task_5354,309,319,10,309,340,0.014
5355,task_5355,1134,1148,14,1134,1210,0.009
5356,task_5356,654,663,9,654,1000,0.01
5357,task_5357,626,633,7,626,702,0.011
5358,task_5358,1306,1317,11,1306,1372,0.01
5359,task_5359,1267,1278,11,1267,1334,0.013
5360,task_5360,1263,1276,13,1263,1289,0.01
5361,task_5361,549,561,12,549,843,0.006
5362,task_5362,835,840,5,835,857,0.007
5363,task_5363,353,367,14,351,912,0.008
5364,task_5364,865,876,11,865,974,0.012
5365,task_5365,418,424,6,418,441,0.01
5366,task_5366,1398,1403,5,1397,1427,0.012
5367,task_5367,321,327,6,321,945,0.006
5368,task_5368,141,150,9,141,626,0.008
5369,task_5369,778,790,12,777,1020,0.012
5370,task_5370,391,396,5,391,940,0.005
5371,task_5371,711,725,14,710,1086,0.011
5372,task_5372,640,646,6,639,907,0.009
5373,task_5373,1114,1119,5,1104,1392,0.006
5374,task_5374,312,325,13,312,1235,0.006
5375,task_5375,128,136,8,124,1432,0.011
5376,task_5376,1110,1116,6,1110,1137,0.009
5377,task_5377,307,312,5,292,1349,0.005
5378,task_5378,1358,1372,14,1358,1416,0.01
5379,task_5379,93,99,6,93,610,0.006
5380,task_5380,1092,1099,7,1092,1127,0.01
5381,task_5381,1272,1278,6,1271,1394,0.01
5382,task_5382,201,210,9,201,1215,0.006
5383,task_5383,229,241,12,229,726,0.008
5384,task_5384,379,384,5,358,1385,0.009
5385,task_5385,813,827,14,812,1315,0.005
5386,task_5386,1028,1034,6,1028,1127,0.008
5387,task_5387,19,32,13,19,861,0.013
5388,task_5388,566,575,9,561,1252,0.01
5389,task_5389,889,898,9,889,1276,0.009
5390,task_5390,1112,1125,13,1109,1369,0.009
5391,task_5391,137,148,11,137,608,0.01
5392,task_5392,1325,1339,14,1325,1423,0.013
5393,task_5393,70,84,14,70,443,0.007
5394,task_5394,1079,1092,13,1078,1197,0.013
5395,task_5395,151,165,14,151,944,0.013
5396,task_5396,1345,1352,7,1345,1394,0.005
5397,task_5397,6,16,10,6,469,0.013
5398,task_5398,1064,1069,5,1064,1111,0.012
5399,task_5399,1162,1173,11,1162,1269,0.01
5400,task_5400,681,691,10,681,1138,0.011
5401,task_5401,493,503,10,493,738,0.011
5402,task_5402,697,710,13,695,1000,0.009
5403,task_5403,537,548,11,536,1173,0.007
5404,task_5404,1158,1166,8,1158,1181,0.013
5405,task_5405,693,707,14,693,1003,0.009
5406,task_5406,360,373,13,360,401,0.014
5407,task_5407,892,901,9,892,1180,0.008
5408,task_5408,234,245,11,232,1326,0.009
5409,task_5409,111,123,12,111,856,0.009
5410,task_5410,943,952,9,943,1026,0.008
5411,task_5411,1018,1029,11,1018,1192,0.005
5412,task_5412,772,778,6,772,942,0.01
5413,task_5413,137,151,14,137,1024,0.012
5414,task_5414,527,541,14,497,1333,0.01
5415,task_5415,951,965,14,951,1219,0.009
5416,task_5416,848,853,5,848,1115,0.006
5417,task_5417,18,29,11,17,711,0.014
5418,task_5418,413,420,7,413,612,0.014
5419,task_5419,558,566,8,558,846,0.011
5420,task_5420,584,589,5,584,1131,0.011
5421,task_5421,535,545,10,535,652,0.006
5422,task_5422,733,742,9,732,1262,0.013
5423,task_5423,268,273,5,268,1135,0.011
5424,task_5424,931,936,5,929,1070,0.011
5425,task_5425,725,737,12,725,879,0.009
5426,task_5426,1280,1287,7,1280,1301,0.013
5427,task_5427,686,692,6,668,1410,0.005
5428,task_5428,134,141,7,131,1424,0.006
5429,task_5429,337,344,7,336,1204,0.009
5430,task_5430,985,990,5,985,1002,0.009
5431,task_5431,253,265,12,253,586,0.011
5432,task_5432,1297,1310,13,1293,1421,0.013
5433,task_5433,1347,1357,10,1346,1419,0.012
5434,task_5434,744,752,8,743,1421,0.009
5435,task_5435,361,369,8,360,566,0.008
5436,task_5436,1197,1207,10,1197,1263,0.011
5437,task_5437,395,408,13,395,562,0.012
5438,task_5438,826,837,11,825,1258,0.01
5439,task_5439,1372,1386,14,1372,1401,0.012
5440,task_5440,563,568,5,563,696,0.012
5441,task_5441,220,227,7,220,736,0.005
5442,task_5442,1187,1193,6,1187,1212,0.008
5443,task_5443,587,596,9,587,1357,0.013
5444,task_5444,642,656,14,639,1370,0.008
5445,task_5445,347,361,14,347,713,0.01
5446,task_5446,546,552,6,546,929,0.005
5447,task_5447,1075,1082,7,1075,1193,0.005
5448,task_5448,1393,1400,7,1393,1425,0.009
5449,task_5449,205,212,7,205,280,0.008
5450,task_5450,353,363,10,350,839,0.007
5451,task_5451,194,201,7,194,1151,0.009
5452,task_5452,87,97,10,87,643,0.005
5453,task_5453,93,105,12,93,1322,0.006
5454,task_5454,990,999,9,990,1079,0.005
5455,task_5455,724,734,10,724,767,0.01
5456,task_5456,376,390,14,376,888,0.007
5457,task_5457,482,491,9,481,1030,0.009
5458,task_5458,803,815,12,795,1210,0.014
5459,task_5459,800,809,9,800,955,0.008
5460,task_5460,762,768,6,761,1401,0.006
5461,task_5461,1193,1204,11,1192,1323,0.011
5462,task_5462,24,36,12,23,659,0.008
5463,task_5463,562,575,13,562,958,0.009
5464,task_5464,505,517,12,501,1244,0.011
5465,task_5465,942,949,7,942,1165,0.006
5466,task_5466,24,30,6,23,641,0.011
5467,task_5467,1014,1022,8,1013,1307,0.012
5468,task_5468,356,367,11,356,1035,0.012
5469,task_5469,14,27,13,14,848,0.008
5470,task_5470,1279,1292,13,1279,1324,0.007
5471,task_5471,1065,1075,10,1065,1272,0.005
5472,task_5472,519,527,8,519,554,0.013
5473,task_5473,1352,1358,6,1279,1433,0.012
5474,task_5474,404,410,6,403,708,0.008
5475,task_5475,370,379,9,370,558,0.007
5476,task_5476,50,64,14,50,1271,0.007
5477,task_5477,351,362,11,351,647,0.01
5478,task_5478,319,330,11,319,715,0.013
5479,task_5479,229,243,14,229,1282,0.01
5480,task_5480,41,51,10,41,872,0.011
5481,task_5481,522,531,9,519,905,0.013
5482,task_5482,190,196,6,190,809,0.006
5483,task_5483,1073,1081,8,1072,1324,0.008
5484,task_5484,1341,1350,9,1341,1380,0.011
5485,task_5485,697,709,12,696,869,0.014
5486,task_5486,891,904,13,891,1324,0.008
5487,task_5487,609,623,14,606,1141,0.014
5488,task_5488,775,783,8,726,1434,0.01
5489,task_5489,1013,1023,10,1012,1247,0.011
5490,task_5490,266,276,10,266,749,0.007
5491,task_5491,1091,1101,10,1089,1207,0.013
5492,task_5492,463,473,10,463,629,0.006
5493,task_5493,908,921,13,902,1350,0.013
5494,task_5494,1301,1311,10,1301,1414,0.008
5495,task_5495,1014,1020,6,1014,1294,0.006
5496,task_5496,394,401,7,394,528,0.009
5497,task_5497,654,662,8,654,763,0.008
5498,task_5498,492,501,9,492,768,0.01
5499,task_5499,1088,1096,8,1088,1311,0.007
5500,task_5500,850,857,7,850,1288,0.011
5501,task_5501,939,951,12,939,1161,0.01
5502,task_5502,1238,1244,6,1238,1404,0.006
5503,task_5503,370,379,9,368,1063,0.011
5504,task_5504,1249,1262,13,1249,1380,0.013
5505,task_5505,1393,1404,11,1392,1426,0.006
5506,task_5506,1061,1073,12,1061,1129,0.005
5507,task_5507,1214,1226,12,1214,1368,0.013
5508,task_5508,249,255,6,249,270,0.013
5509,task_5509,477,487,10,477,1327,0.007
5510,task_5510,1148,1162,14,1148,1226,0.008
5511,task_5511,109,123,14,109,720,0.009
5512,task_5512,121,134,13,121,603,0.005
5513,task_5513,498,512,14,497,1160,0.005
5514,task_5514,1115,1120,5,1115,1154,0.011
5515,task_5515,1222,1234,12,1222,1299,0.01
5516,task_5516,1041,1049,8,1040,1100,0.012
5517,task_5517,1231,1239,8,1231,1298,0.005
5518,task_5518,904,916,12,896,1269,0.013
5519,task_5519,1177,1184,7,1177,1288,0.01
5520,task_5520,182,194,12,182,789,0.009
5521,task_5521,338,344,6,338,1154,0.006
5522,task_5522,858,865,7,858,1096,0.007
5523,task_5523,256,265,9,256,1291,0.006
5524,task_5524,289,294,5,289,1114,0.01
5525,task_5525,1160,1168,8,1159,1306,0.008
5526,task_5526,1310,1319,9,1309,1389,0.014
5527,task_5527,1179,1184,5,1176,1409,0.009
5528,task_5528,921,933,12,921,1044,0.011
5529,task_5529,946,960,14,945,1252,0.009
5530,task_5530,1263,1276,13,1263,1290,0.013
5531,task_5531,434,445,11,434,1240,0.007
5532,task_5532,471,479,8,471,1089,0.005
5533,task_5533,1059,1065,6,1058,1192,0.012
5534,task_5534,365,376,11,364,798,0.014
5535,task_5535,1264,1274,10,1264,1337,0.014
5536,task_5536,127,133,6,127,1091,0.008
5537,task_5537,720,730,10,720,1298,0.014
5538,task_5538,853,859,6,853,1036,0.009
5539,task_5539,232,240,8,232,653,0.006
5540,task_5540,827,838,11,827,1183,0.006
5541,task_5541,100,113,13,100,924,0.014
5542,task_5542,43,52,9,43,880,0.011
5543,task_5543,869,878,9,869,1023,0.012
5544,task_5544,1265,1277,12,1265,1319,0.006
5545,task_5545,679,692,13,679,1165,0.007
5546,task_5546,698,711,13,697,1069,0.006
5547,task_5547,885,893,8,885,972,0.008
5548,task_5548,1382,1392,10,1374,1437,0.006
5549,task_5549,525,532,7,524,718,0.013
5550,task_5550,1212,1225,13,1212,1328,0.009
5551,task_5551,228,235,7,228,1219,0.01
5552,task_5552,226,239,13,222,1370,0.007
5553,task_5553,894,904,10,894,1352,0.007
5554,task_5554,1088,1100,12,1088,1221,0.006
5555,task_5555,1218,1227,9,976,1429,0.012
5556,task_5556,824,835,11,824,1019,0.006
5557,task_5557,114,121,7,114,133,0.008
5558,task_5558,231,245,14,231,563,0.01
5559,task_5559,408,421,13,408,549,0.009
5560,task_5560,387,396,9,387,974,0.008
5561,task_5561,1365,1379,14,1365,1404,0.01
5562,task_5562,1174,1179,5,1174,1239,0.01
5563,task_5563,1351,1358,7,1351,1383,0.01
5564,task_5564,163,169,6,163,805,0.005
5565,task_5565,679,685,6,679,1212,0.006
5566,task_5566,613,621,8,613,1068,0.013
5567,task_5567,1233,1238,5,1233,1259,0.009
5568,task_5568,254,260,6,254,350,0.005
5569,task_5569,824,829,5,823,1291,0.014
5570,task_5570,1350,1356,6,1278,1431,0.005
5571,task_5571,1262,1270,8,1256,1406,0.013
5572,task_5572,491,505,14,491,977,0.012
5573,task_5573,1079,1086,7,1077,1181,0.01
5574,task_5574,777,790,13,777,836,0.01
5575,task_5575,779,792,13,776,1192,0.01
5576,task_5576,1233,1245,12,1233,1362,0.014
5577,task_5577,390,396,6,390,808,0.006
5578,task_5578,496,504,8,496,602,0.008
5579,task_5579,675,688,13,675,1017,0.005
5580,task_5580,1292,1302,10,1286,1402,0.007
5581,task_5581,945,953,8,945,1098,0.007
5582,task_5582,1059,1064,5,1059,1089,0.014
5583,task_5583,1378,1384,6,1374,1426,0.007
5584,task_5584,785,794,9,785,1075,0.005
5585,task_5585,118,128,10,114,1413,0.011
5586,task_5586,1021,1030,9,1021,1064,0.008
5587,task_5587,594,601,7,502,1416,0.014
5588,task_5588,297,305,8,297,854,0.008
5589,task_5589,917,926,9,909,1399,0.005
5590,task_5590,1234,1246,12,1234,1285,0.012
5591,task_5591,1163,1177,14,1162,1345,0.013
5592,task_5592,127,134,7,127,435,0.008
5593,task_5593,1321,1333,12,1321,1403,0.01
5594,task_5594,1266,1278,12,1266,1371,0.006
5595,task_5595,995,1000,5,995,1150,0.008
5596,task_5596,396,409,13,396,622,0.013
5597,task_5597,1126,1139,13,1126,1203,0.013
5598,task_5598,570,581,11,570,875,0.006
5599,task_5599,1017,1027,10,1017,1288,0.009
5600,task_5600,385,398,13,385,710,0.013
5601,task_5601,472,479,7,472,822,0.011
5602,task_5602,169,174,5,169,1022,0.009
5603,task_5603,1071,1082,11,1071,1175,0.005
5604,task_5604,174,187,13,174,1219,0.006
5605,task_5605,244,257,13,244,876,0.008
5606,task_5606,829,841,12,829,1205,0.008
5607,task_5607,11,17,6,11,65,0.008
5608,task_5608,46,56,10,46,602,0.01
5609,task_5609,553,558,5,552,1106,0.006
5610,task_5610,286,291,5,286,493,0.008
5611,task_5611,924,932,8,924,949,0.014
5612,task_5612,174,182,8,174,221,0.007
5613,task_5613,32,42,10,32,864,0.011
5614,task_5614,461,466,5,461,645,0.011
5615,task_5615,978,983,5,977,1326,0.014
5616,task_5616,1359,1373,14,1359,1414,0.006
5617,task_5617,1230,1237,7,1230,1253,0.008
5618,task_5618,549,562,13,549,659,0.008
5619,task_5619,452,465,13,452,484,0.006
5620,task_5620,521,529,8,521,551,0.007
5621,task_5621,809,823,14,795,1295,0.011
5622,task_5622,1325,1339,14,1289,1433,0.008
5623,task_5623,913,924,11,913,1290,0.008
5624,task_5624,465,479,14,465,786,0.005
5625,task_5625,377,385,8,377,1195,0.012
5626,task_5626,1156,1166,10,1155,1202,0.011
5627,task_5627,454,468,14,454,751,0.007
5628,task_5628,326,331,5,326,814,0.007
5629,task_5629,795,801,6,795,984,0.007
5630,task_5630,763,776,13,763,1016,0.011
5631,task_5631,1304,1318,14,1304,1354,0.01
5632,task_5632,875,887,12,875,971,0.01
5633,task_5633,247,252,5,247,881,0.007
5634,task_5634,107,115,8,107,498,0.012
5635,task_5635,979,990,11,979,1258,0.014
5636,task_5636,264,276,12,264,801,0.006
5637,task_5637,646,654,8,646,1224,0.012
5638,task_5638,1239,1252,13,1239,1288,0.005
5639,task_5639,342,349,7,342,1216,0.013
5640,task_5640,202,208,6,202,238,0.005
5641,task_5641,515,522,7,515,783,0.014
5642,task_5642,841,852,11,841,1214,0.013
5643,task_5643,1111,1120,9,1111,1145,0.01
5644,task_5644,1318,1330,12,1316,1419,0.008
5645,task_5645,1166,1176,10,1161,1415,0.011
5646,task_5646,809,817,8,808,1294,0.011
5647,task_5647,1055,1068,13,1037,1387,0.006
5648,task_5648,1287,1292,5,1286,1367,0.009
5649,task_5649,1362,1373,11,1362,1387,0.014
5650,task_5650,133,140,7,133,1182,0.007
5651,task_5651,283,295,12,283,460,0.005
5652,task_5652,653,661,8,652,1135,0.013
5653,task_5653,579,593,14,579,1095,0.012
5654,task_5654,443,448,5,443,1429,0.014
5655,task_5655,1273,1284,11,1273,1403,0.006
5656,task_5656,315,325,10,313,1421,0.006
5657,task_5657,750,762,12,749,1210,0.012
5658,task_5658,981,987,6,981,1221,0.013
5659,task_5659,741,746,5,741,773,0.005
5660,task_5660,725,736,11,695,1360,0.014
5661,task_5661,372,386,14,372,1071,0.006
5662,task_5662,1230,1241,11,1230,1327,0.008
5663,task_5663,1095,1108,13,1095,1279,0.011
5664,task_5664,161,168,7,161,1418,0.01
5665,task_5665,688,699,11,688,1289,0.008
5666,task_5666,282,289,7,282,1016,0.011
5667,task_5667,1314,1320,6,1314,1367,0.009
5668,task_5668,433,446,13,433,564,0.008
5669,task_5669,42,48,6,42,319,0.013
5670,task_5670,1290,1295,5,1284,1386,0.013
5671,task_5671,283,289,6,283,461,0.014
5672,task_5672,237,243,6,237,813,0.006
5673,task_5673,642,650,8,642,1324,0.006
5674,task_5674,1167,1181,14,1167,1302,0.007
5675,task_5675,1380,1390,10,1380,1411,0.005
5676,task_5676,208,220,12,208,556,0.008
5677,task_5677,290,300,10,290,622,0.012
5678,task_5678,128,134,6,128,1177,0.013
5679,task_5679,142,154,12,142,320,0.009
5680,task_5680,271,277,6,269,1137,0.008
5681,task_5681,541,553,12,529,1370,0.013
5682,task_5682,263,275,12,263,439,0.009
5683,task_5683,1119,1125,6,1119,1174,0.011
5684,task_5684,1253,1264,11,1253,1303,0.013
5685,task_5685,895,904,9,894,1371,0.014
5686,task_5686,786,796,10,785,1078,0.01
5687,task_5687,638,648,10,635,1194,0.008
5688,task_5688,113,123,10,107,1198,0.007
5689,task_5689,1277,1283,6,1274,1369,0.011
5690,task_5690,114,124,10,114,149,0.011
5691,task_5691,1394,1403,9,1394,1417,0.012
5692,task_5692,600,605,5,600,1116,0.011
5693,task_5693,713,718,5,702,1298,0.005
5694,task_5694,1208,1217,9,1208,1306,0.007
5695,task_5695,118,129,11,112,1349,0.006
5696,task_5696,997,1008,11,997,1214,0.005
5697,task_5697,662,676,14,660,815,0.008
5698,task_5698,1167,1181,14,1167,1336,0.013
5699,task_5699,383,393,10,383,613,0.011
5700,task_5700,477,487,10,477,1212,0.011
5701,task_5701,980,985,5,980,1019,0.013
5702,task_5702,1383,1388,5,1383,1417,0.007
5703,task_5703,1209,1223,14,1209,1364,0.006
5704,task_5704,823,835,12,823,982,0.006
5705,task_5705,811,825,14,811,946,0.009
5706,task_5706,274,280,6,274,1133,0.008
5707,task_5707,490,500,10,488,852,0.014
5708,task_5708,287,297,10,287,574,0.012
5709,task_5709,530,542,12,520,1345,0.007
5710,task_5710,1262,1267,5,1055,1434,0.01
5711,task_5711,346,356,10,346,1181,0.005
5712,task_5712,395,409,14,395,494,0.008
5713,task_5713,985,997,12,925,1419,0.008
5714,task_5714,1302,1314,12,1272,1430,0.014
5715,task_5715,1125,1133,8,1125,1196,0.014
5716,task_5716,469,478,9,469,801,0.009
5717,task_5717,949,957,8,949,1022,0.009
5718,task_5718,420,427,7,420,1067,0.009
5719,task_5719,411,416,5,411,940,0.008
5720,task_5720,190,201,11,190,999,0.008
5721,task_5721,1363,1371,8,1363,1422,0.012
5722,task_5722,220,228,8,220,749,0.008
5723,task_5723,887,898,11,882,1293,0.008
5724,task_5724,1206,1218,12,1205,1295,0.01
5725,task_5725,1339,1352,13,1339,1377,0.006
5726,task_5726,160,172,12,160,336,0.014
5727,task_5727,205,219,14,205,802,0.005
5728,task_5728,778,789,11,777,870,0.009
5729,task_5729,1045,1059,14,1045,1085,0.01
5730,task_5730,275,283,8,275,1345,0.012
5731,task_5731,116,128,12,116,275,0.009
5732,task_5732,754,766,12,754,812,0.008
5733,task_5733,1264,1271,7,1264,1330,0.005
5734,task_5734,562,568,6,558,1072,0.013
5735,task_5735,294,308,14,294,484,0.007
5736,task_5736,997,1008,11,997,1228,0.007
5737,task_5737,786,794,8,782,1259,0.007
5738,task_5738,905,912,7,898,1298,0.011
5739,task_5739,981,995,14,980,1083,0.01
5740,task_5740,116,126,10,115,1234,0.012
5741,task_5741,1353,1367,14,1353,1406,0.012
5742,task_5742,584,598,14,584,1027,0.005
5743,task_5743,1076,1084,8,820,1425,0.006
5744,task_5744,523,529,6,522,1279,0.012
5745,task_5745,414,423,9,413,1257,0.006
5746,task_5746,76,87,11,76,1126,0.005
5747,task_5747,862,870,8,862,1243,0.011
5748,task_5748,542,550,8,542,754,0.007
5749,task_5749,1181,1194,13,1119,1431,0.012
5750,task_5750,764,770,6,764,1153,0.005
5751,task_5751,838,849,11,838,1030,0.006
5752,task_5752,4,12,8,4,431,0.014
5753,task_5753,188,193,5,188,537,0.012
5754,task_5754,1029,1036,7,1023,1305,0.013
5755,task_5755,699,711,12,698,1176,0.007
5756,task_5756,236,244,8,234,1428,0.008
5757,task_5757,1320,1325,5,1264,1423,0.01
5758,task_5758,958,963,5,958,1011,0.011
5759,task_5759,707,718,11,707,886,0.014
5760,task_5760,1103,1110,7,1103,1306,0.005
5761,task_5761,168,173,5,167,1388,0.013
5762,task_5762,354,360,6,354,399,0.007
5763,task_5763,298,303,5,298,314,0.009
5764,task_5764,79,90,11,79,982,0.013
5765,task_5765,912,926,14,910,1318,0.012
5766,task_5766,1083,1095,12,1083,1148,0.009
5767,task_5767,189,200,11,189,1361,0.012
5768,task_5768,816,824,8,796,1334,0.014
5769,task_5769,118,131,13,117,746,0.012
5770,task_5770,487,495,8,487,959,0.008
5771,task_5771,709,714,5,704,1233,0.014
5772,task_5772,122,133,11,122,734,0.006
5773,task_5773,254,261,7,254,1017,0.012
5774,task_5774,184,190,6,184,389,0.005
5775,task_5775,792,797,5,791,1149,0.008
5776,task_5776,544,551,7,543,1244,0.005
5777,task_5777,1069,1074,5,1069,1342,0.008
5778,task_5778,856,861,5,854,1292,0.008
5779,task_5779,335,345,10,335,640,0.011
5780,task_5780,128,136,8,128,322,0.006
5781,task_5781,975,981,6,975,1268,0.008
5782,task_5782,566,580,14,566,1001,0.008
5783,task_5783,1337,1346,9,1337,1405,0.005
5784,task_5784,785,798,13,783,1063,0.006
5785,task_5785,118,127,9,118,373,0.009
5786,task_5786,984,995,11,984,1042,0.013
5787,task_5787,739,750,11,738,829,0.013
5788,task_5788,673,685,12,672,892,0.005
5789,task_5789,1352,1362,10,1338,1437,0.007
5790,task_5790,1072,1080,8,1072,1149,0.007
5791,task_5791,1198,1205,7,1196,1361,0.011
5792,task_5792,466,474,8,466,877,0.007
5793,task_5793,376,387,11,374,896,0.012
5794,task_5794,681,686,5,680,852,0.006
5795,task_5795,617,628,11,617,793,0.012
5796,task_5796,1157,1163,6,1154,1331,0.01
5797,task_5797,1014,1026,12,1014,1117,0.005
5798,task_5798,96,105,9,96,1206,0.011
5799,task_5799,9,19,10,9,1284,0.014
5800,task_5800,963,977,14,949,1412,0.005
5801,task_5801,553,567,14,553,1002,0.012
5802,task_5802,1018,1031,13,1018,1231,0.005
5803,task_5803,933,943,10,929,1163,0.011
5804,task_5804,1339,1347,8,1339,1412,0.009
5805,task_5805,1158,1172,14,1157,1360,0.005
5806,task_5806,56,63,7,56,715,0.008
5807,task_5807,72,83,11,72,833,0.014
5808,task_5808,183,195,12,183,1176,0.012
5809,task_5809,799,805,6,799,860,0.011
5810,task_5810,362,371,9,362,841,0.014
5811,task_5811,604,614,10,604,866,0.01
5812,task_5812,741,752,11,741,1169,0.008
5813,task_5813,75,89,14,75,661,0.014
5814,task_5814,264,278,14,264,840,0.008
5815,task_5815,780,793,13,780,874,0.008
5816,task_5816,1337,1342,5,1335,1400,0.008
5817,task_5817,536,550,14,536,1160,0.014
5818,task_5818,444,456,12,444,1412,0.009
5819,task_5819,634,646,12,633,1320,0.01
5820,task_5820,266,271,5,266,466,0.006
5821,task_5821,792,798,6,789,1163,0.007
5822,task_5822,797,805,8,797,977,0.013
5823,task_5823,84,89,5,84,635,0.005
5824,task_5824,685,697,12,680,1400,0.01
5825,task_5825,1394,1399,5,1392,1429,0.014
5826,task_5826,1319,1327,8,1314,1418,0.014
5827,task_5827,203,211,8,203,754,0.011
5828,task_5828,1359,1369,10,1359,1395,0.008
5829,task_5829,939,950,11,939,1014,0.009
5830,task_5830,990,995,5,990,1168,0.011
5831,task_5831,538,546,8,538,661,0.006
5832,task_5832,1330,1343,13,1330,1434,0.006
5833,task_5833,1269,1277,8,1269,1349,0.011
5834,task_5834,759,767,8,759,1048,0.014
5835,task_5835,836,849,13,836,1059,0.014
5836,task_5836,851,860,9,851,1050,0.007
5837,task_5837,145,150,5,144,1162,0.006
5838,task_5838,277,285,8,277,326,0.012
5839,task_5839,1397,1405,8,1397,1427,0.005
5840,task_5840,216,225,9,216,270,0.01
5841,task_5841,880,891,11,880,991,0.01
5842,task_5842,416,430,14,416,752,0.007
5843,task_5843,164,169,5,164,1141,0.007
5844,task_5844,64,71,7,64,677,0.009
5845,task_5845,173,183,10,173,386,0.009
5846,task_5846,465,479,14,465,1297,0.013
5847,task_5847,584,590,6,584,1378,0.012
5848,task_5848,1039,1050,11,1039,1221,0.013
5849,task_5849,632,644,12,632,1061,0.013
5850,task_5850,113,118,5,110,1186,0.006
5851,task_5851,288,301,13,288,959,0.014
5852,task_5852,933,944,11,929,1250,0.01
5853,task_5853,975,981,6,975,1382,0.012
5854,task_5854,705,713,8,705,1032,0.014
5855,task_5855,334,346,12,334,867,0.011
5856,task_5856,145,157,12,145,676,0.009
5857,task_5857,1209,1214,5,1206,1423,0.006
5858,task_5858,697,708,11,696,894,0.008
5859,task_5859,873,883,10,871,1357,0.01
5860,task_5860,713,727,14,711,1268,0.008
5861,task_5861,1285,1295,10,1285,1313,0.012
5862,task_5862,608,622,14,607,863,0.013
5863,task_5863,434,444,10,434,1330,0.005
5864,task_5864,1229,1243,14,1229,1293,0.009
5865,task_5865,914,920,6,911,1378,0.006
5866,task_5866,773,778,5,773,821,0.011
5867,task_5867,267,272,5,265,1427,0.014
5868,task_5868,1220,1226,6,1220,1354,0.011
5869,task_5869,1139,1147,8,1139,1390,0.008
5870,task_5870,974,987,13,974,1237,0.007
5871,task_5871,678,690,12,660,1359,0.009
5872,task_5872,434,444,10,434,1042,0.01
5873,task_5873,824,829,5,824,1233,0.012
5874,task_5874,622,629,7,622,1334,0.01
5875,task_5875,914,921,7,895,1385,0.012
5876,task_5876,886,891,5,886,1266,0.006
5877,task_5877,119,128,9,119,723,0.009
5878,task_5878,855,867,12,855,937,0.014
5879,task_5879,396,406,10,395,783,0.01
5880,task_5880,1317,1327,10,1317,1358,0.005
5881,task_5881,1283,1290,7,1283,1304,0.012
5882,task_5882,1372,1384,12,1372,1414,0.009
5883,task_5883,568,573,5,558,1328,0.007
5884,task_5884,8,14,6,8,909,0.005
5885,task_5885,1128,1134,6,1125,1317,0.006
5886,task_5886,171,185,14,171,723,0.009
5887,task_5887,997,1004,7,989,1365,0.014
5888,task_5888,532,540,8,531,1005,0.011
5889,task_5889,11,19,8,11,562,0.014
5890,task_5890,356,364,8,354,1111,0.009
5891,task_5891,697,708,11,697,873,0.009
5892,task_5892,516,522,6,516,629,0.014
5893,task_5893,574,588,14,574,1062,0.005
5894,task_5894,536,547,11,535,671,0.007
5895,task_5895,676,685,9,674,1188,0.012
5896,task_5896,742,753,11,738,1380,0.011
5897,task_5897,49,54,5,49,756,0.014
5898,task_5898,275,283,8,275,1193,0.011
5899,task_5899,1242,1251,9,1242,1342,0.01
5900,task_5900,398,409,11,398,1057,0.01
5901,task_5901,255,267,12,255,323,0.011
5902,task_5902,933,939,6,933,1217,0.014
5903,task_5903,1047,1055,8,1032,1367,0.014
5904,task_5904,1154,1166,12,1154,1198,0.01
5905,task_5905,405,413,8,405,868,0.014
5906,task_5906,380,386,6,380,520,0.006
5907,task_5907,190,199,9,190,533,0.012
5908,task_5908,307,317,10,295,1397,0.012
5909,task_5909,1088,1095,7,1083,1366,0.012
5910,task_5910,708,714,6,708,855,0.012
5911,task_5911,899,912,13,896,1210,0.008
5912,task_5912,400,413,13,400,750,0.013
5913,task_5913,1050,1064,14,1050,1373,0.006
5914,task_5914,447,455,8,447,1213,0.01
5915,task_5915,171,183,12,171,1024,0.008
5916,task_5916,758,772,14,749,1430,0.006
5917,task_5917,51,57,6,51,922,0.012
5918,task_5918,6,16,10,6,53,0.014
5919,task_5919,1124,1138,14,1123,1379,0.007
5920,task_5920,1347,1359,12,1347,1378,0.014
5921,task_5921,385,392,7,385,1022,0.006
5922,task_5922,1361,1368,7,1361,1388,0.006
5923,task_5923,1088,1098,10,1084,1363,0.009
5924,task_5924,498,509,11,497,977,0.013
5925,task_5925,923,935,12,920,1317,0.005
5926,task_5926,686,699,13,660,1422,0.011
5927,task_5927,1034,1039,5,1034,1085,0.011
5928,task_5928,1027,1034,7,1027,1139,0.009
5929,task_5929,556,563,7,555,756,0.012
5930,task_5930,1280,1291,11,1280,1317,0.013
5931,task_5931,1399,1412,13,1398,1437,0.006
5932,task_5932,262,270,8,262,480,0.013
5933,task_5933,1185,1199,14,1185,1247,0.009
5934,task_5934,113,123,10,112,881,0.006
5935,task_5935,294,299,5,293,1065,0.01
5936,task_5936,32,43,11,32,381,0.009
5937,task_5937,984,996,12,982,1415,0.011
5938,task_5938,1167,1177,10,1167,1217,0.008
5939,task_5939,180,187,7,180,683,0.01
5940,task_5940,247,257,10,247,1332,0.009
5941,task_5941,703,715,12,701,1062,0.011
5942,task_5942,240,248,8,240,462,0.01
5943,task_5943,43,53,10,43,96,0.007
5944,task_5944,343,353,10,343,800,0.01
5945,task_5945,879,889,10,879,953,0.006
5946,task_5946,888,894,6,888,1203,0.006
5947,task_5947,1260,1265,5,1258,1341,0.01
5948,task_5948,685,699,14,651,1408,0.007
5949,task_5949,862,868,6,826,1379,0.007
5950,task_5950,1399,1407,8,1399,1436,0.012
5951,task_5951,334,343,9,334,871,0.005
5952,task_5952,699,713,14,699,862,0.011
5953,task_5953,578,589,11,577,709,0.007
5954,task_5954,1244,1251,7,1244,1295,0.008
5955,task_5955,141,146,5,141,556,0.006
5956,task_5956,497,508,11,497,816,0.009
5957,task_5957,1328,1341,13,1328,1406,0.007
5958,task_5958,39,46,7,39,523,0.007
5959,task_5959,356,370,14,355,1105,0.01
5960,task_5960,1080,1094,14,1079,1256,0.007
5961,task_5961,1288,1294,6,1288,1364,0.006
5962,task_5962,449,458,9,449,1069,0.013
5963,task_5963,588,600,12,543,1403,0.013
5964,task_5964,463,477,14,463,964,0.014
5965,task_5965,354,362,8,353,1050,0.01
5966,task_5966,106,118,12,106,241,0.012
5967,task_5967,1397,1406,9,1397,1417,0.01
5968,task_5968,415,429,14,415,586,0.005
5969,task_5969,352,365,13,352,789,0.007
5970,task_5970,122,127,5,122,664,0.012
5971,task_5971,384,393,9,383,863,0.011
5972,task_5972,260,265,5,260,1193,0.014
5973,task_5973,1097,1103,6,1096,1395,0.006
5974,task_5974,713,722,9,713,1066,0.006
5975,task_5975,1375,1382,7,1375,1413,0.007
5976,task_5976,601,607,6,601,1067,0.005
5977,task_5977,116,130,14,116,695,0.005
5978,task_5978,1275,1286,11,1275,1356,0.013
5979,task_5979,231,240,9,231,857,0.014
5980,task_5980,393,406,13,357,1434,0.007
5981,task_5981,1054,1066,12,1052,1380,0.013
5982,task_5982,1133,1139,6,1133,1326,0.013
5983,task_5983,755,769,14,755,986,0.005
5984,task_5984,58,70,12,58,517,0.009
5985,task_5985,1341,1348,7,1340,1369,0.01
5986,task_5986,944,950,6,944,1001,0.006
5987,task_5987,816,825,9,816,880,0.009
5988,task_5988,686,692,6,686,1068,0.011
5989,task_5989,489,498,9,488,822,0.009
5990,task_5990,750,761,11,750,1233,0.014
5991,task_5991,517,529,12,517,971,0.005
5992,task_5992,1260,1273,13,1260,1316,0.007
5993,task_5993,296,307,11,294,1163,0.006
5994,task_5994,895,902,7,895,1075,0.008
5995,task_5995,983,997,14,983,1104,0.011
5996,task_5996,1137,1144,7,1137,1190,0.014
5997,task_5997,206,216,10,206,553,0.008
5998,task_5998,532,544,12,532,780,0.014
5999,task_5999,124,133,9,124,147,0.007
