task No.,task_name,start_time,end_time,execution_time,earliest_time,latest_time,resource_load
0,task_0,867,878,11,867,1006,0.005
1,task_1,74,87,13,73,836,0.012
2,task_2,414,419,5,411,1096,0.005
3,task_3,206,212,6,204,1324,0.006
4,task_4,1115,1122,7,1110,1381,0.014
5,task_5,1386,1400,14,1386,1419,0.006
6,task_6,211,223,12,210,1400,0.01
7,task_7,768,773,5,768,893,0.009
8,task_8,539,546,7,539,880,0.011
9,task_9,1129,1137,8,1129,1294,0.007
10,task_10,883,893,10,881,1036,0.009
11,task_11,364,372,8,364,565,0.008
12,task_12,603,609,6,603,1348,0.01
13,task_13,393,398,5,391,420,0.014
14,task_14,147,157,10,144,582,0.013
15,task_15,374,387,13,374,428,0.005
16,task_16,332,342,10,332,750,0.007
17,task_17,897,909,12,896,1053,0.011
18,task_18,528,533,5,528,807,0.01
19,task_19,97,107,10,94,859,0.011
20,task_20,180,190,10,180,1253,0.013
21,task_21,632,638,6,632,1124,0.011
22,task_22,548,557,9,547,743,0.013
23,task_23,1234,1241,7,1234,1303,0.006
24,task_24,1342,1350,8,1046,1436,0.008
25,task_25,945,954,9,945,1046,0.008
26,task_26,36,50,14,36,1360,0.005
27,task_27,778,789,11,778,869,0.014
28,task_28,69,76,7,63,739,0.005
29,task_29,1165,1179,14,1160,1383,0.009
30,task_30,828,841,13,827,1052,0.011
31,task_31,1020,1033,13,1020,1203,0.01
32,task_32,565,574,9,547,1334,0.007
33,task_33,900,906,6,898,1169,0.006
34,task_34,598,606,8,598,1182,0.013
35,task_35,705,719,14,704,993,0.005
36,task_36,421,433,12,407,1318,0.009
37,task_37,465,474,9,465,598,0.006
38,task_38,1115,1125,10,1111,1383,0.009
39,task_39,914,921,7,914,961,0.006
40,task_40,882,890,8,882,929,0.006
41,task_41,83,92,9,82,334,0.005
42,task_42,964,972,8,930,1362,0.013
43,task_43,78,88,10,74,1112,0.01
44,task_44,892,900,8,884,1332,0.014
45,task_45,597,611,14,597,1379,0.014
46,task_46,229,235,6,229,1382,0.005
47,task_47,142,147,5,142,330,0.01
48,task_48,938,946,8,937,1239,0.008
49,task_49,519,527,8,496,1285,0.012
50,task_50,907,914,7,899,1318,0.012
51,task_51,193,201,8,192,590,0.012
52,task_52,1027,1038,11,1025,1297,0.012
53,task_53,291,305,14,291,578,0.014
54,task_54,415,426,11,415,450,0.009
55,task_55,725,734,9,725,856,0.006
56,task_56,380,390,10,380,467,0.006
57,task_57,1188,1202,14,1182,1342,0.008
58,task_58,1089,1098,9,1085,1284,0.014
59,task_59,1163,1174,11,1161,1341,0.012
60,task_60,827,838,11,827,928,0.012
61,task_61,333,339,6,333,576,0.014
62,task_62,19,27,8,19,472,0.01
63,task_63,114,119,5,113,538,0.007
64,task_64,738,751,13,738,946,0.006
65,task_65,1193,1204,11,1192,1271,0.012
66,task_66,695,701,6,694,734,0.007
67,task_67,277,291,14,276,689,0.014
68,task_68,1265,1278,13,1265,1326,0.006
69,task_69,5,11,6,5,1133,0.013
70,task_70,1261,1274,13,1261,1310,0.008
71,task_71,1322,1336,14,1322,1433,0.005
72,task_72,492,505,13,491,1036,0.012
73,task_73,772,781,9,771,1140,0.012
74,task_74,932,937,5,927,1211,0.011
75,task_75,343,349,6,339,1096,0.006
76,task_76,938,943,5,932,1275,0.008
77,task_77,281,291,10,280,713,0.007
78,task_78,317,328,11,311,1313,0.007
79,task_79,662,674,12,662,923,0.01
80,task_80,314,325,11,314,1249,0.01
81,task_81,1378,1390,12,1375,1434,0.01
82,task_82,804,813,9,804,890,0.014
83,task_83,123,128,5,122,849,0.006
84,task_84,320,334,14,320,532,0.009
85,task_85,390,398,8,389,1120,0.014
86,task_86,1122,1127,5,1010,1412,0.011
87,task_87,442,451,9,442,944,0.008
88,task_88,1399,1405,6,1395,1436,0.01
89,task_89,655,669,14,648,1133,0.007
90,task_90,876,883,7,876,1119,0.007
91,task_91,792,804,12,788,1125,0.014
92,task_92,1315,1325,10,1313,1429,0.006
93,task_93,474,480,6,474,1412,0.005
94,task_94,419,433,14,415,1256,0.01
95,task_95,998,1011,13,998,1318,0.005
96,task_96,38,44,6,38,476,0.009
97,task_97,1133,1139,6,1133,1165,0.011
98,task_98,1015,1025,10,1012,1146,0.011
99,task_99,107,118,11,102,797,0.008
100,task_100,1095,1106,11,1093,1332,0.012
101,task_101,669,677,8,658,1422,0.006
102,task_102,1374,1386,12,1374,1417,0.011
103,task_103,16,24,8,16,125,0.011
104,task_104,840,854,14,839,1260,0.005
105,task_105,1117,1127,10,1070,1411,0.011
106,task_106,1073,1081,8,1072,1295,0.005
107,task_107,907,913,6,907,1060,0.007
108,task_108,1140,1146,6,1140,1271,0.01
109,task_109,182,192,10,182,212,0.006
110,task_110,380,387,7,380,435,0.007
111,task_111,512,519,7,510,884,0.013
112,task_112,973,985,12,972,1297,0.008
113,task_113,1007,1020,13,1007,1322,0.005
114,task_114,817,830,13,817,1207,0.011
115,task_115,801,810,9,794,1150,0.006
116,task_116,1247,1259,12,1247,1369,0.007
117,task_117,984,991,7,829,1409,0.007
118,task_118,1255,1263,8,1248,1401,0.007
119,task_119,440,453,13,440,591,0.014
120,task_120,371,379,8,363,1235,0.01
121,task_121,65,73,8,64,478,0.014
122,task_122,152,164,12,152,242,0.006
123,task_123,1221,1231,10,1221,1261,0.011
124,task_124,1027,1038,11,1025,1298,0.005
125,task_125,55,63,8,55,1208,0.01
126,task_126,1064,1075,11,1063,1212,0.012
127,task_127,968,977,9,967,1048,0.014
128,task_128,1297,1304,7,1297,1377,0.006
129,task_129,766,780,14,764,1045,0.011
130,task_130,1179,1192,13,1179,1318,0.007
131,task_131,1310,1324,14,1309,1335,0.012
132,task_132,897,903,6,895,964,0.013
133,task_133,312,326,14,310,574,0.012
134,task_134,274,281,7,272,1258,0.006
135,task_135,248,258,10,248,293,0.006
136,task_136,251,260,9,251,909,0.005
137,task_137,840,851,11,818,1315,0.005
138,task_138,836,843,7,835,928,0.01
139,task_139,1085,1096,11,1085,1155,0.01
140,task_140,287,298,11,276,1342,0.011
141,task_141,350,355,5,350,636,0.006
142,task_142,613,621,8,613,1242,0.007
143,task_143,1176,1190,14,1174,1412,0.014
144,task_144,984,990,6,911,1404,0.007
145,task_145,1267,1274,7,1265,1422,0.013
146,task_146,833,842,9,830,1112,0.013
147,task_147,1273,1281,8,1273,1301,0.013
148,task_148,1138,1145,7,1131,1369,0.014
149,task_149,684,697,13,682,1185,0.005
150,task_150,532,543,11,532,1010,0.013
151,task_151,716,726,10,716,1056,0.006
152,task_152,148,155,7,143,1200,0.008
153,task_153,451,458,7,451,1072,0.008
154,task_154,1188,1198,10,1188,1340,0.006
155,task_155,365,376,11,364,882,0.013
156,task_156,608,622,14,608,1416,0.011
157,task_157,726,731,5,725,1381,0.007
158,task_158,744,758,14,736,1367,0.014
159,task_159,417,428,11,415,695,0.013
160,task_160,52,64,12,52,559,0.011
161,task_161,1053,1064,11,1053,1231,0.011
162,task_162,486,494,8,485,839,0.011
163,task_163,647,658,11,647,767,0.014
164,task_164,375,388,13,375,694,0.011
165,task_165,237,243,6,237,662,0.009
166,task_166,847,856,9,800,1329,0.005
167,task_167,655,667,12,651,1036,0.011
168,task_168,1003,1008,5,1003,1208,0.008
169,task_169,773,780,7,765,1352,0.008
170,task_170,1134,1142,8,1133,1169,0.005
171,task_171,156,165,9,155,553,0.011
172,task_172,516,529,13,512,1131,0.012
173,task_173,1347,1359,12,1347,1386,0.01
174,task_174,238,250,12,238,466,0.009
175,task_175,1067,1080,13,1067,1245,0.014
176,task_176,419,431,12,418,896,0.009
177,task_177,170,182,12,170,1220,0.011
178,task_178,1210,1223,13,1210,1398,0.008
179,task_179,1198,1212,14,1193,1363,0.01
180,task_180,1319,1331,12,1299,1439,0.012
181,task_181,885,897,12,885,949,0.007
182,task_182,1381,1386,5,1380,1435,0.008
183,task_183,493,499,6,493,540,0.01
184,task_184,165,177,12,163,1347,0.012
185,task_185,109,114,5,109,679,0.006
186,task_186,1110,1121,11,1108,1145,0.012
187,task_187,876,884,8,873,1376,0.014
188,task_188,36,46,10,36,928,0.007
189,task_189,1219,1229,10,1219,1287,0.008
190,task_190,560,571,11,560,771,0.011
191,task_191,325,334,9,325,751,0.013
192,task_192,48,56,8,48,1205,0.011
193,task_193,490,503,13,490,1205,0.007
194,task_194,909,915,6,877,1379,0.01
195,task_195,1195,1200,5,1194,1311,0.01
196,task_196,527,539,12,518,1366,0.007
197,task_197,1125,1138,13,1028,1420,0.013
198,task_198,724,733,9,724,1182,0.005
199,task_199,1255,1263,8,1253,1397,0.006
200,task_200,434,444,10,434,472,0.009
201,task_201,467,476,9,465,1218,0.014
202,task_202,1315,1329,14,1311,1436,0.005
203,task_203,211,225,14,193,1438,0.012
204,task_204,637,651,14,637,859,0.006
205,task_205,755,763,8,754,912,0.01
206,task_206,679,691,12,679,1307,0.013
207,task_207,715,723,8,715,1127,0.009
208,task_208,309,320,11,309,522,0.012
209,task_209,1389,1394,5,1389,1416,0.013
210,task_210,983,990,7,983,1000,0.014
211,task_211,1388,1395,7,1388,1420,0.005
212,task_212,632,644,12,632,1345,0.009
213,task_213,706,719,13,706,1070,0.011
214,task_214,1393,1406,13,1392,1423,0.006
215,task_215,1055,1061,6,1037,1325,0.009
216,task_216,693,702,9,650,1433,0.008
217,task_217,920,934,14,918,1240,0.014
218,task_218,351,365,14,351,1117,0.005
219,task_219,1041,1055,14,1041,1141,0.009
220,task_220,780,789,9,776,1027,0.009
221,task_221,1202,1212,10,1202,1226,0.007
222,task_222,1146,1151,5,1146,1183,0.01
223,task_223,565,578,13,555,1286,0.011
224,task_224,667,677,10,665,1328,0.013
225,task_225,1251,1263,12,1248,1321,0.012
226,task_226,941,952,11,941,1309,0.013
227,task_227,559,565,6,558,665,0.011
228,task_228,931,942,11,930,1083,0.014
229,task_229,1007,1020,13,1006,1254,0.006
230,task_230,1356,1367,11,1351,1429,0.012
231,task_231,1263,1270,7,1258,1374,0.009
232,task_232,926,939,13,926,1062,0.006
233,task_233,1093,1098,5,1084,1305,0.013
234,task_234,1045,1058,13,1043,1267,0.006
235,task_235,69,78,9,69,494,0.006
236,task_236,305,316,11,305,647,0.006
237,task_237,961,974,13,961,1066,0.006
238,task_238,1350,1355,5,1350,1424,0.005
239,task_239,886,900,14,880,1234,0.009
240,task_240,659,672,13,655,1184,0.006
241,task_241,1258,1263,5,1258,1369,0.006
242,task_242,223,229,6,223,401,0.014
243,task_243,595,600,5,595,737,0.006
244,task_244,527,536,9,526,1329,0.011
245,task_245,625,630,5,625,1322,0.008
246,task_246,590,595,5,590,1310,0.012
247,task_247,706,718,12,706,776,0.006
248,task_248,13,25,12,13,347,0.012
249,task_249,931,938,7,926,1136,0.01
250,task_250,1310,1317,7,1309,1343,0.009
251,task_251,24,33,9,24,1400,0.007
252,task_252,1240,1247,7,841,1426,0.013
253,task_253,22,33,11,22,1109,0.006
254,task_254,693,706,13,693,757,0.01
255,task_255,93,106,13,93,700,0.008
256,task_256,1134,1144,10,1133,1359,0.012
257,task_257,455,469,14,455,981,0.008
258,task_258,758,770,12,750,1263,0.012
259,task_259,1361,1367,6,1361,1428,0.014
260,task_260,42,51,9,42,568,0.009
261,task_261,634,644,10,634,1424,0.013
262,task_262,405,417,12,405,934,0.006
263,task_263,38,43,5,38,607,0.01
264,task_264,884,891,7,881,1111,0.005
265,task_265,1179,1186,7,1145,1411,0.006
266,task_266,744,750,6,743,815,0.014
267,task_267,1025,1035,10,1025,1100,0.006
268,task_268,646,659,13,646,1360,0.01
269,task_269,691,699,8,691,774,0.006
270,task_270,1009,1014,5,1009,1290,0.005
271,task_271,673,679,6,672,945,0.009
272,task_272,298,308,10,298,1146,0.007
273,task_273,592,602,10,592,1285,0.008
274,task_274,1397,1409,12,1395,1433,0.013
275,task_275,1319,1330,11,1318,1432,0.012
276,task_276,1361,1366,5,1361,1411,0.005
277,task_277,1273,1283,10,1268,1390,0.008
278,task_278,674,684,10,674,851,0.009
279,task_279,583,590,7,583,1085,0.009
280,task_280,380,394,14,358,1309,0.013
281,task_281,990,1002,12,990,1113,0.008
282,task_282,74,85,11,58,905,0.012
283,task_283,892,900,8,891,1377,0.013
284,task_284,872,883,11,870,902,0.009
285,task_285,1100,1105,5,1099,1215,0.01
286,task_286,1233,1247,14,1007,1431,0.009
287,task_287,1254,1265,11,1250,1391,0.008
288,task_288,964,972,8,931,1349,0.006
289,task_289,457,466,9,457,1269,0.009
290,task_290,195,208,13,195,557,0.006
291,task_291,638,646,8,638,772,0.014
292,task_292,579,590,11,579,1054,0.006
293,task_293,95,105,10,95,660,0.01
294,task_294,973,983,10,972,1262,0.014
295,task_295,863,875,12,817,1374,0.006
296,task_296,359,372,13,358,540,0.005
297,task_297,641,655,14,641,681,0.012
298,task_298,869,881,12,790,1387,0.009
299,task_299,1344,1351,7,1344,1406,0.008
300,task_300,274,288,14,271,1199,0.013
301,task_301,997,1008,11,996,1313,0.007
302,task_302,773,781,8,773,925,0.01
303,task_303,719,728,9,719,1040,0.008
304,task_304,577,588,11,577,696,0.009
305,task_305,650,664,14,648,1084,0.01
306,task_306,67,74,7,60,731,0.007
307,task_307,1305,1314,9,1279,1425,0.011
308,task_308,1030,1038,8,1030,1172,0.011
309,task_309,658,670,12,658,1023,0.008
310,task_310,819,829,10,817,1235,0.014
311,task_311,84,95,11,81,794,0.009
312,task_312,371,379,8,371,398,0.013
313,task_313,384,393,9,384,464,0.009
314,task_314,453,458,5,453,1296,0.012
315,task_315,1293,1303,10,1292,1373,0.012
316,task_316,846,856,10,843,1244,0.013
317,task_317,1334,1342,8,1334,1381,0.012
318,task_318,1131,1141,10,1131,1210,0.012
319,task_319,561,568,7,561,653,0.006
320,task_320,922,931,9,798,1389,0.01
321,task_321,1018,1030,12,1017,1116,0.011
322,task_322,780,790,10,779,878,0.006
323,task_323,327,337,10,327,1270,0.005
324,task_324,388,401,13,388,505,0.006
325,task_325,441,450,9,439,1261,0.006
326,task_326,570,581,11,570,665,0.011
327,task_327,667,679,12,647,1313,0.012
328,task_328,238,252,14,238,339,0.011
329,task_329,188,196,8,188,1193,0.006
330,task_330,824,837,13,822,1189,0.007
331,task_331,341,355,14,340,419,0.012
332,task_332,950,956,6,950,968,0.013
333,task_333,1298,1306,8,1298,1357,0.012
334,task_334,1171,1176,5,1171,1389,0.013
335,task_335,1353,1362,9,1353,1383,0.011
336,task_336,905,915,10,902,1067,0.013
337,task_337,983,997,14,892,1405,0.012
338,task_338,269,277,8,267,322,0.012
339,task_339,736,748,12,736,1237,0.008
340,task_340,387,400,13,386,795,0.014
341,task_341,66,75,9,66,468,0.007
342,task_342,1058,1065,7,1058,1291,0.009
343,task_343,759,765,6,759,1054,0.006
344,task_344,1384,1397,13,1384,1430,0.01
345,task_345,435,442,7,429,1307,0.006
346,task_346,901,913,12,901,1247,0.014
347,task_347,44,52,8,40,962,0.011
348,task_348,1042,1051,9,1042,1100,0.007
349,task_349,240,251,11,240,842,0.007
350,task_350,117,124,7,80,1401,0.011
351,task_351,685,691,6,671,1373,0.011
352,task_352,1296,1305,9,1295,1383,0.01
353,task_353,1229,1235,6,1229,1283,0.013
354,task_354,1195,1202,7,1194,1237,0.013
355,task_355,686,692,6,686,1386,0.01
356,task_356,87,99,12,85,749,0.009
357,task_357,336,345,9,333,752,0.006
358,task_358,1301,1310,9,1291,1414,0.011
359,task_359,1082,1096,14,1082,1141,0.013
360,task_360,1198,1206,8,1192,1353,0.008
361,task_361,933,938,5,930,1246,0.014
362,task_362,1256,1267,11,1256,1295,0.013
363,task_363,1342,1350,8,1231,1436,0.006
364,task_364,107,121,14,107,336,0.005
365,task_365,1221,1229,8,1221,1340,0.008
366,task_366,725,735,10,702,1357,0.014
367,task_367,361,369,8,361,731,0.009
368,task_368,918,924,6,918,962,0.009
369,task_369,471,478,7,471,611,0.012
370,task_370,193,206,13,193,343,0.009
371,task_371,772,782,10,764,1178,0.01
372,task_372,794,801,7,794,816,0.013
373,task_373,1061,1066,5,1040,1331,0.008
374,task_374,745,759,14,745,982,0.007
375,task_375,1016,1025,9,1014,1161,0.005
376,task_376,791,799,8,790,959,0.007
377,task_377,58,65,7,57,670,0.005
378,task_378,1265,1271,6,1264,1288,0.006
379,task_379,591,598,7,591,1434,0.009
380,task_380,167,175,8,161,1388,0.005
381,task_381,85,91,6,85,366,0.008
382,task_382,1281,1287,6,1281,1310,0.011
383,task_383,624,636,12,624,1421,0.014
384,task_384,46,55,9,37,1387,0.01
385,task_385,552,561,9,551,914,0.013
386,task_386,862,876,14,862,1290,0.006
387,task_387,118,126,8,61,1423,0.007
388,task_388,209,222,13,209,1259,0.008
389,task_389,36,44,8,36,107,0.01
390,task_390,528,542,14,528,697,0.005
391,task_391,963,971,8,963,1068,0.01
392,task_392,785,798,13,785,1043,0.008
393,task_393,55,64,9,55,1430,0.005
394,task_394,1222,1233,11,1217,1375,0.006
395,task_395,436,448,12,436,494,0.011
396,task_396,1177,1188,11,1177,1243,0.011
397,task_397,1061,1067,6,1061,1127,0.013
398,task_398,1349,1359,10,930,1438,0.009
399,task_399,758,771,13,746,1256,0.013
400,task_400,1143,1154,11,1142,1170,0.011
401,task_401,746,757,11,746,811,0.009
402,task_402,1178,1185,7,1154,1407,0.014
403,task_403,1189,1199,10,1189,1231,0.009
404,task_404,1045,1053,8,1042,1182,0.014
405,task_405,554,567,13,547,1064,0.014
406,task_406,1278,1286,8,1277,1399,0.008
407,task_407,897,907,10,897,962,0.006
408,task_408,1254,1266,12,1254,1338,0.005
409,task_409,971,976,5,969,1274,0.012
410,task_410,576,586,10,576,1092,0.007
411,task_411,1101,1106,5,1080,1379,0.005
412,task_412,1263,1269,6,1263,1393,0.005
413,task_413,369,375,6,369,937,0.013
414,task_414,808,815,7,808,1052,0.008
415,task_415,699,707,8,699,833,0.006
416,task_416,252,259,7,252,1202,0.012
417,task_417,612,622,10,612,768,0.01
418,task_418,677,687,10,676,1247,0.007
419,task_419,1167,1177,10,1166,1348,0.011
420,task_420,873,879,6,873,1236,0.005
421,task_421,1324,1337,13,1323,1385,0.008
422,task_422,256,266,10,256,333,0.01
423,task_423,362,375,13,362,508,0.013
424,task_424,1340,1351,11,1335,1416,0.005
425,task_425,1284,1297,13,1283,1348,0.009
426,task_426,42,55,13,42,163,0.01
427,task_427,1351,1364,13,1351,1412,0.008
428,task_428,1356,1366,10,1356,1388,0.009
429,task_429,934,942,8,925,1249,0.011
430,task_430,655,663,8,655,1046,0.005
431,task_431,250,258,8,250,501,0.006
432,task_432,1060,1073,13,1060,1245,0.011
433,task_433,1099,1112,13,1099,1164,0.01
434,task_434,666,680,14,660,1307,0.008
435,task_435,328,333,5,328,729,0.006
436,task_436,712,724,12,710,1211,0.009
437,task_437,1336,1343,7,1336,1356,0.008
438,task_438,181,186,5,181,1270,0.008
439,task_439,229,243,14,229,589,0.005
440,task_440,684,697,13,683,905,0.008
441,task_441,1233,1245,12,967,1429,0.011
442,task_442,1330,1338,8,1330,1356,0.006
443,task_443,940,948,8,940,1042,0.01
444,task_444,829,836,7,826,1067,0.013
445,task_445,1213,1218,5,1213,1348,0.007
446,task_446,48,54,6,48,1232,0.005
447,task_447,91,97,6,90,935,0.011
448,task_448,525,532,7,524,1331,0.007
449,task_449,1076,1081,5,1075,1398,0.009
450,task_450,476,486,10,476,1039,0.008
451,task_451,1025,1031,6,1024,1163,0.009
452,task_452,1098,1108,10,1077,1383,0.008
453,task_453,307,321,14,302,1005,0.009
454,task_454,304,310,6,304,688,0.007
455,task_455,283,289,6,283,1172,0.012
456,task_456,1356,1361,5,1354,1416,0.007
457,task_457,363,374,11,363,576,0.005
458,task_458,757,768,11,757,812,0.006
459,task_459,821,827,6,821,922,0.01
460,task_460,592,602,10,592,1433,0.014
461,task_461,328,339,11,328,671,0.009
462,task_462,331,336,5,330,1023,0.011
463,task_463,426,440,14,419,1431,0.014
464,task_464,1,9,8,1,1088,0.009
465,task_465,260,272,12,260,483,0.008
466,task_466,623,633,10,623,1354,0.009
467,task_467,1337,1347,10,1337,1363,0.009
468,task_468,1357,1364,7,972,1439,0.014
469,task_469,250,256,6,249,1261,0.005
470,task_470,260,269,9,259,999,0.012
471,task_471,286,295,9,285,986,0.01
472,task_472,1033,1038,5,1033,1148,0.006
473,task_473,364,374,10,364,472,0.006
474,task_474,123,136,13,123,688,0.012
475,task_475,1212,1219,7,1212,1273,0.012
476,task_476,1051,1061,10,1040,1301,0.01
477,task_477,398,408,10,397,664,0.009
478,task_478,95,109,14,94,161,0.013
479,task_479,1246,1254,8,1246,1265,0.014
480,task_480,300,305,5,300,746,0.01
481,task_481,379,390,11,379,982,0.008
482,task_482,172,181,9,172,1011,0.008
483,task_483,868,876,8,818,1376,0.014
484,task_484,1327,1341,14,1327,1407,0.011
485,task_485,1377,1389,12,1376,1423,0.01
486,task_486,439,446,7,438,545,0.007
487,task_487,1140,1152,12,1140,1250,0.013
488,task_488,485,498,13,485,842,0.01
489,task_489,738,750,12,738,867,0.012
490,task_490,754,759,5,754,890,0.011
491,task_491,1144,1152,8,1144,1282,0.014
492,task_492,433,439,6,433,512,0.008
493,task_493,500,512,12,500,722,0.005
494,task_494,362,373,11,362,1144,0.009
495,task_495,1165,1176,11,1164,1321,0.014
496,task_496,962,970,8,961,1133,0.006
497,task_497,100,114,14,100,871,0.006
498,task_498,87,94,7,85,662,0.006
499,task_499,723,731,8,709,1327,0.01
500,task_500,733,745,12,732,1097,0.011
501,task_501,763,773,10,763,938,0.01
502,task_502,808,817,9,808,1146,0.014
503,task_503,620,626,6,620,912,0.009
504,task_504,215,223,8,215,708,0.008
505,task_505,1193,1202,9,1193,1294,0.01
506,task_506,1144,1155,11,886,1425,0.013
507,task_507,158,163,5,158,1311,0.013
508,task_508,1350,1356,6,1350,1423,0.012
509,task_509,34,46,12,34,986,0.011
510,task_510,1229,1237,8,1229,1341,0.01
511,task_511,708,722,14,705,1294,0.013
512,task_512,405,419,14,348,1383,0.009
513,task_513,1404,1409,5,1380,1438,0.011
514,task_514,505,519,14,485,1261,0.014
515,task_515,530,540,10,507,1429,0.006
516,task_516,456,464,8,456,1389,0.005
517,task_517,1386,1399,13,1386,1417,0.006
518,task_518,370,380,10,370,767,0.009
519,task_519,518,526,8,518,704,0.008
520,task_520,1020,1027,7,1017,1216,0.014
521,task_521,731,738,7,730,1081,0.012
522,task_522,1227,1233,6,1227,1267,0.014
523,task_523,1266,1275,9,1265,1328,0.006
524,task_524,1023,1037,14,1023,1182,0.01
525,task_525,707,712,5,696,1255,0.013
526,task_526,417,427,10,408,1177,0.008
527,task_527,913,923,10,913,964,0.006
528,task_528,238,245,7,238,1334,0.007
529,task_529,552,565,13,552,957,0.005
530,task_530,650,660,10,649,1103,0.011
531,task_531,621,634,13,617,984,0.014
532,task_532,1314,1321,7,1313,1355,0.013
533,task_533,196,205,9,196,236,0.008
534,task_534,1329,1342,13,1327,1413,0.013
535,task_535,148,158,10,137,1226,0.014
536,task_536,956,970,14,956,1062,0.006
537,task_537,1193,1198,5,1191,1342,0.013
538,task_538,942,954,12,942,1331,0.012
539,task_539,130,143,13,130,1240,0.014
540,task_540,1399,1404,5,1397,1435,0.008
541,task_541,1321,1330,9,1320,1367,0.007
542,task_542,1188,1198,10,990,1424,0.012
543,task_543,323,336,13,323,1108,0.011
544,task_544,1304,1317,13,1304,1387,0.008
545,task_545,949,956,7,949,1120,0.011
546,task_546,1038,1045,7,1038,1204,0.005
547,task_547,18,31,13,18,78,0.009
548,task_548,208,217,9,208,1361,0.014
549,task_549,73,79,6,71,655,0.012
550,task_550,503,512,9,503,1067,0.01
551,task_551,406,417,11,401,1425,0.005
552,task_552,627,639,12,627,1197,0.014
553,task_553,197,206,9,197,1221,0.013
554,task_554,922,931,9,922,1069,0.008
555,task_555,559,570,11,556,743,0.011
556,task_556,88,95,7,88,823,0.012
557,task_557,1366,1378,12,1365,1400,0.007
558,task_558,712,724,12,711,769,0.01
559,task_559,986,994,8,728,1413,0.005
560,task_560,396,405,9,396,1074,0.007
561,task_561,989,1002,13,988,1398,0.01
562,task_562,1053,1059,6,1053,1077,0.01
563,task_563,1400,1407,7,1378,1439,0.007
564,task_564,1066,1073,7,1031,1373,0.012
565,task_565,198,211,13,192,1334,0.008
566,task_566,78,86,8,77,966,0.006
567,task_567,1169,1175,6,1147,1405,0.009
568,task_568,198,204,6,197,1271,0.013
569,task_569,1041,1055,14,1041,1177,0.005
570,task_570,798,811,13,798,1057,0.007
571,task_571,559,568,9,558,647,0.005
572,task_572,470,476,6,470,790,0.008
573,task_573,1232,1239,7,1231,1394,0.006
574,task_574,1398,1408,10,1388,1436,0.013
575,task_575,610,622,12,610,978,0.014
576,task_576,639,644,5,639,702,0.014
577,task_577,701,706,5,701,796,0.005
578,task_578,1157,1167,10,1155,1268,0.014
579,task_579,289,300,11,260,1421,0.009
580,task_580,1076,1090,14,1051,1407,0.009
581,task_581,772,777,5,772,1195,0.005
582,task_582,868,881,13,867,1214,0.012
583,task_583,1260,1266,6,1259,1356,0.01
584,task_584,826,838,12,826,965,0.01
585,task_585,275,287,12,275,641,0.009
586,task_586,841,851,10,841,1303,0.005
587,task_587,440,451,11,438,783,0.013
588,task_588,1292,1299,7,1291,1347,0.007
589,task_589,1352,1358,6,1352,1416,0.007
590,task_590,65,75,10,62,598,0.012
591,task_591,543,549,6,538,1391,0.006
592,task_592,486,492,6,484,854,0.014
593,task_593,702,715,13,702,828,0.005
594,task_594,873,879,6,871,1199,0.01
595,task_595,993,1000,7,991,1174,0.01
596,task_596,1245,1251,6,908,1430,0.007
597,task_597,336,348,12,333,719,0.013
598,task_598,1104,1115,11,1101,1387,0.014
599,task_599,118,124,6,101,1409,0.011
600,task_600,642,655,13,642,1284,0.005
601,task_601,494,505,11,494,1126,0.009
602,task_602,294,303,9,292,752,0.014
603,task_603,1091,1103,12,1091,1201,0.012
604,task_604,643,650,7,643,886,0.012
605,task_605,876,885,9,874,1374,0.012
606,task_606,1093,1101,8,1093,1131,0.011
607,task_607,1098,1112,14,1098,1278,0.014
608,task_608,449,456,7,449,816,0.007
609,task_609,810,820,10,792,1222,0.012
610,task_610,2,14,12,2,65,0.005
611,task_611,465,472,7,465,885,0.012
612,task_612,937,942,5,935,1035,0.008
613,task_613,379,388,9,379,758,0.013
614,task_614,657,667,10,652,1142,0.011
615,task_615,849,862,13,813,1340,0.013
616,task_616,1000,1005,5,1000,1250,0.014
617,task_617,210,219,9,210,1058,0.009
618,task_618,190,204,14,189,1200,0.014
619,task_619,1091,1104,13,1084,1294,0.014
620,task_620,396,406,10,395,1033,0.014
621,task_621,355,361,6,355,949,0.006
622,task_622,774,785,11,774,834,0.013
623,task_623,1305,1317,12,1270,1434,0.012
624,task_624,596,602,6,596,996,0.011
625,task_625,972,983,11,972,1052,0.008
626,task_626,1237,1251,14,1237,1328,0.011
627,task_627,885,897,12,882,1161,0.014
628,task_628,744,756,12,732,1387,0.01
629,task_629,400,411,11,362,1342,0.01
630,task_630,1139,1144,5,1132,1395,0.012
631,task_631,317,325,8,302,1309,0.014
632,task_632,32,45,13,32,1281,0.007
633,task_633,477,489,12,477,1024,0.012
634,task_634,25,30,5,25,776,0.007
635,task_635,339,351,12,339,502,0.01
636,task_636,845,854,9,844,1220,0.008
637,task_637,1163,1174,11,1159,1352,0.012
638,task_638,1202,1209,7,1201,1307,0.005
639,task_639,233,239,6,233,901,0.012
640,task_640,813,820,7,808,1262,0.007
641,task_641,1088,1100,12,1078,1280,0.013
642,task_642,1101,1110,9,1099,1357,0.011
643,task_643,833,841,8,828,1176,0.008
644,task_644,258,266,8,258,321,0.01
645,task_645,1110,1115,5,1108,1155,0.006
646,task_646,1290,1302,12,1290,1340,0.007
647,task_647,957,964,7,935,1340,0.006
648,task_648,520,525,5,520,568,0.006
649,task_649,214,225,11,214,397,0.012
650,task_650,128,134,6,128,175,0.008
651,task_651,1225,1238,13,810,1429,0.012
652,task_652,813,821,8,801,1308,0.006
653,task_653,960,974,14,959,1309,0.007
654,task_654,368,377,9,368,519,0.005
655,task_655,759,772,13,759,1018,0.013
656,task_656,279,289,10,277,1025,0.014
657,task_657,156,163,7,151,829,0.01
658,task_658,372,380,8,372,724,0.013
659,task_659,1057,1064,7,1057,1100,0.005
660,task_660,417,427,10,413,1233,0.005
661,task_661,1250,1255,5,1249,1297,0.012
662,task_662,21,27,6,21,1214,0.01
663,task_663,1101,1111,10,1100,1287,0.014
664,task_664,583,588,5,583,1002,0.014
665,task_665,820,829,9,820,1126,0.006
666,task_666,953,963,10,951,1302,0.009
667,task_667,1233,1240,7,1233,1334,0.007
668,task_668,365,370,5,365,900,0.005
669,task_669,143,148,5,143,819,0.014
670,task_670,5,10,5,5,143,0.01
671,task_671,481,492,11,479,1176,0.013
672,task_672,824,838,14,820,1190,0.005
673,task_673,965,975,10,965,1001,0.008
674,task_674,915,926,11,913,1376,0.014
675,task_675,1260,1273,13,1259,1340,0.013
676,task_676,1219,1231,12,1219,1319,0.005
677,task_677,1143,1153,10,1141,1400,0.005
678,task_678,1141,1150,9,1141,1233,0.01
679,task_679,413,421,8,411,1061,0.01
680,task_680,676,684,8,674,1161,0.01
681,task_681,423,437,14,423,940,0.005
682,task_682,1267,1278,11,1264,1421,0.009
683,task_683,733,746,13,733,1172,0.008
684,task_684,954,968,14,954,1197,0.009
685,task_685,1334,1341,7,1334,1383,0.01
686,task_686,701,714,13,697,1002,0.01
687,task_687,1215,1223,8,1215,1328,0.014
688,task_688,70,75,5,70,832,0.006
689,task_689,671,679,8,670,1300,0.012
690,task_690,387,395,8,387,423,0.006
691,task_691,507,521,14,507,602,0.014
692,task_692,1387,1398,11,1385,1423,0.01
693,task_693,999,1007,8,996,1373,0.012
694,task_694,107,117,10,104,959,0.007
695,task_695,750,761,11,746,959,0.009
696,task_696,157,167,10,157,857,0.006
697,task_697,53,63,10,53,244,0.006
698,task_698,123,128,5,121,854,0.014
699,task_699,1212,1222,10,1210,1417,0.013
700,task_700,527,534,7,524,1387,0.008
701,task_701,1212,1221,9,1212,1380,0.01
702,task_702,1300,1314,14,1300,1386,0.007
703,task_703,461,474,13,461,1038,0.012
704,task_704,550,564,14,547,1006,0.013
705,task_705,1134,1144,10,1134,1227,0.008
706,task_706,156,167,11,156,458,0.008
707,task_707,356,362,6,345,1283,0.005
708,task_708,1263,1271,8,792,1434,0.012
709,task_709,954,963,9,945,1341,0.013
710,task_710,1390,1403,13,1390,1428,0.008
711,task_711,1182,1195,13,1182,1314,0.005
712,task_712,1067,1073,6,1067,1381,0.007
713,task_713,315,323,8,315,866,0.007
714,task_714,162,169,7,161,721,0.011
715,task_715,715,725,10,694,1323,0.011
716,task_716,857,862,5,854,1157,0.008
717,task_717,163,171,8,162,1077,0.013
718,task_718,289,299,10,288,1306,0.007
719,task_719,65,78,13,64,517,0.011
720,task_720,452,457,5,452,1200,0.012
721,task_721,1118,1129,11,1118,1253,0.008
722,task_722,1242,1252,10,844,1429,0.012
723,task_723,1011,1023,12,1005,1414,0.006
724,task_724,1381,1387,6,1375,1431,0.008
725,task_725,997,1011,14,996,1130,0.013
726,task_726,658,666,8,648,1157,0.014
727,task_727,115,123,8,78,1360,0.013
728,task_728,1105,1115,10,1090,1389,0.006
729,task_729,459,466,7,459,497,0.012
730,task_730,293,300,7,293,375,0.007
731,task_731,810,818,8,810,992,0.01
732,task_732,1312,1322,10,1311,1418,0.007
733,task_733,1073,1086,13,1055,1404,0.007
734,task_734,581,587,6,581,899,0.005
735,task_735,970,975,5,969,1030,0.012
736,task_736,36,46,10,36,131,0.011
737,task_737,313,323,10,311,1203,0.008
738,task_738,303,312,9,303,613,0.013
739,task_739,346,360,14,331,1270,0.007
740,task_740,112,125,13,112,589,0.005
741,task_741,235,249,14,235,698,0.014
742,task_742,811,823,12,801,1262,0.005
743,task_743,1169,1176,7,1169,1301,0.013
744,task_744,1400,1408,8,1399,1439,0.005
745,task_745,946,952,6,946,984,0.005
746,task_746,1292,1301,9,1292,1363,0.007
747,task_747,302,313,11,301,737,0.009
748,task_748,690,703,13,690,973,0.008
749,task_749,1398,1407,9,1398,1436,0.007
750,task_750,37,49,12,37,1203,0.011
751,task_751,542,553,11,540,969,0.014
752,task_752,829,838,9,828,1070,0.008
753,task_753,148,161,13,145,1097,0.006
754,task_754,356,368,12,347,1216,0.013
755,task_755,1162,1169,7,1159,1232,0.007
756,task_756,819,830,11,819,1059,0.01
757,task_757,201,214,13,200,585,0.014
758,task_758,942,950,8,932,1321,0.014
759,task_759,490,497,7,480,1192,0.013
760,task_760,674,684,10,672,986,0.013
761,task_761,830,843,13,829,1099,0.006
762,task_762,702,714,12,702,745,0.009
763,task_763,251,258,7,251,505,0.01
764,task_764,893,905,12,893,928,0.013
765,task_765,195,208,13,195,924,0.006
766,task_766,100,111,11,100,548,0.006
767,task_767,1055,1065,10,1055,1102,0.013
768,task_768,692,705,13,692,1382,0.007
769,task_769,318,323,5,318,1100,0.012
770,task_770,549,559,10,548,855,0.012
771,task_771,459,465,6,459,1394,0.008
772,task_772,258,267,9,258,392,0.008
773,task_773,1034,1044,10,1033,1273,0.008
774,task_774,1263,1269,6,1263,1380,0.014
775,task_775,1254,1262,8,1254,1305,0.01
776,task_776,578,590,12,577,1060,0.012
777,task_777,58,70,12,57,352,0.008
778,task_778,376,388,12,376,914,0.005
779,task_779,261,274,13,256,1343,0.01
780,task_780,1127,1133,6,1034,1416,0.013
781,task_781,93,106,13,92,1179,0.008
782,task_782,555,560,5,547,1221,0.011
783,task_783,75,87,12,75,865,0.007
784,task_784,498,508,10,495,1071,0.008
785,task_785,1061,1067,6,1061,1145,0.007
786,task_786,861,873,12,860,1323,0.012
787,task_787,435,440,5,435,1297,0.005
788,task_788,351,364,13,348,846,0.008
789,task_789,508,516,8,508,541,0.011
790,task_790,1048,1061,13,1046,1281,0.013
791,task_791,404,414,10,404,1191,0.005
792,task_792,246,255,9,246,394,0.013
793,task_793,353,365,12,353,973,0.013
794,task_794,1231,1244,13,1231,1265,0.01
795,task_795,1139,1144,5,1139,1182,0.005
796,task_796,431,441,10,431,1117,0.008
797,task_797,1038,1045,7,1038,1140,0.014
798,task_798,577,585,8,577,686,0.011
799,task_799,964,975,11,964,1282,0.007
800,task_800,900,911,11,896,1130,0.012
801,task_801,828,840,12,828,1045,0.011
802,task_802,565,578,13,547,1340,0.009
803,task_803,992,998,6,991,1065,0.011
804,task_804,208,221,13,208,1347,0.006
805,task_805,430,442,12,429,485,0.009
806,task_806,757,762,5,756,1233,0.007
807,task_807,666,675,9,665,1027,0.008
808,task_808,479,486,7,479,739,0.012
809,task_809,499,505,6,499,936,0.009
810,task_810,1020,1034,14,1014,1173,0.007
811,task_811,1152,1157,5,1152,1292,0.006
812,task_812,84,91,7,81,1075,0.007
813,task_813,759,764,5,759,999,0.01
814,task_814,343,356,13,341,905,0.013
815,task_815,540,546,6,540,785,0.011
816,task_816,1005,1015,10,1001,1251,0.014
817,task_817,298,309,11,298,751,0.012
818,task_818,1167,1174,7,1148,1402,0.008
819,task_819,12,20,8,12,152,0.01
820,task_820,1200,1209,9,1198,1378,0.01
821,task_821,1015,1021,6,1013,1153,0.008
822,task_822,745,757,12,745,903,0.005
823,task_823,760,774,14,760,896,0.009
824,task_824,1342,1349,7,845,1434,0.006
825,task_825,97,110,13,88,1186,0.008
826,task_826,1096,1101,5,1096,1176,0.006
827,task_827,567,578,11,566,847,0.014
828,task_828,301,306,5,301,477,0.012
829,task_829,379,384,5,379,642,0.011
830,task_830,361,371,10,357,1272,0.014
831,task_831,1155,1169,14,1155,1250,0.014
832,task_832,1066,1075,9,1062,1378,0.011
833,task_833,124,132,8,121,904,0.006
834,task_834,542,555,13,539,1212,0.012
835,task_835,406,416,10,355,1424,0.009
836,task_836,1112,1117,5,1111,1347,0.014
837,task_837,235,245,10,235,1004,0.005
838,task_838,1104,1117,13,1104,1287,0.012
839,task_839,1375,1385,10,1365,1431,0.006
840,task_840,740,750,10,738,1121,0.01
841,task_841,1222,1233,11,1222,1337,0.006
842,task_842,441,452,11,439,942,0.011
843,task_843,684,691,7,676,1369,0.012
844,task_844,1251,1260,9,1251,1361,0.007
845,task_845,1175,1188,13,1173,1371,0.009
846,task_846,1317,1328,11,1317,1417,0.008
847,task_847,1278,1288,10,1278,1370,0.007
848,task_848,291,304,13,291,1052,0.012
849,task_849,454,466,12,454,888,0.008
850,task_850,1341,1349,8,1339,1416,0.014
851,task_851,991,999,8,991,1018,0.013
852,task_852,388,398,10,388,1145,0.008
853,task_853,66,78,12,66,479,0.008
854,task_854,881,890,9,881,957,0.01
855,task_855,864,873,9,765,1371,0.008
856,task_856,159,170,11,159,561,0.005
857,task_857,1389,1399,10,1389,1417,0.012
858,task_858,1158,1163,5,1149,1367,0.01
859,task_859,1269,1283,14,1269,1360,0.01
860,task_860,110,122,12,106,1034,0.008
861,task_861,838,849,11,820,1236,0.008
862,task_862,687,695,8,687,1343,0.006
863,task_863,367,379,12,367,905,0.008
864,task_864,824,834,10,821,1029,0.007
865,task_865,1199,1212,13,1194,1362,0.01
866,task_866,155,162,7,153,385,0.006
867,task_867,915,925,10,915,1184,0.006
868,task_868,942,947,5,942,1208,0.005
869,task_869,244,249,5,244,264,0.014
870,task_870,48,58,10,48,380,0.01
871,task_871,1350,1356,6,698,1437,0.01
872,task_872,997,1011,14,996,1353,0.014
873,task_873,1112,1120,8,1106,1346,0.013
874,task_874,948,953,5,946,1107,0.014
875,task_875,750,760,10,747,918,0.01
876,task_876,604,616,12,604,839,0.005
877,task_877,987,997,10,867,1423,0.007
878,task_878,225,236,11,224,992,0.013
879,task_879,1231,1240,9,1231,1290,0.006
880,task_880,1208,1222,14,1187,1428,0.011
881,task_881,862,869,7,860,1342,0.013
882,task_882,776,783,7,776,873,0.012
883,task_883,121,126,5,121,543,0.01
884,task_884,567,573,6,567,845,0.006
885,task_885,750,759,9,750,907,0.014
886,task_886,1204,1211,7,1204,1312,0.011
887,task_887,735,744,9,731,1285,0.011
888,task_888,401,414,13,370,1361,0.007
889,task_889,1385,1398,13,1385,1412,0.013
890,task_890,813,819,6,812,962,0.009
891,task_891,131,144,13,131,887,0.009
892,task_892,543,549,6,543,611,0.005
893,task_893,132,139,7,131,967,0.007
894,task_894,1384,1390,6,1384,1437,0.007
895,task_895,1116,1130,14,1085,1401,0.009
896,task_896,1162,1167,5,1160,1222,0.011
897,task_897,1011,1020,9,1002,1399,0.007
898,task_898,468,482,14,462,1238,0.008
899,task_899,712,726,14,711,852,0.007
900,task_900,998,1004,6,998,1298,0.011
901,task_901,543,554,11,543,992,0.005
902,task_902,406,411,5,360,1417,0.01
903,task_903,921,931,10,745,1388,0.013
904,task_904,464,469,5,464,963,0.01
905,task_905,1252,1260,8,1252,1369,0.009
906,task_906,92,100,8,92,315,0.008
907,task_907,922,933,11,828,1392,0.007
908,task_908,590,604,14,590,938,0.009
909,task_909,59,69,10,59,289,0.005
910,task_910,201,215,14,199,267,0.007
911,task_911,800,813,13,800,969,0.005
912,task_912,163,169,6,163,1131,0.008
913,task_913,986,993,7,794,1415,0.013
914,task_914,55,69,14,55,841,0.01
915,task_915,783,792,9,783,822,0.006
916,task_916,1284,1292,8,1284,1340,0.009
917,task_917,189,198,9,189,907,0.011
918,task_918,205,211,6,202,1060,0.005
919,task_919,557,565,8,556,586,0.012
920,task_920,781,791,10,781,1005,0.007
921,task_921,803,810,7,794,1180,0.014
922,task_922,69,83,14,61,851,0.008
923,task_923,157,162,5,149,989,0.005
924,task_924,1187,1193,6,1185,1291,0.012
925,task_925,479,486,7,479,792,0.014
926,task_926,1157,1170,13,1156,1341,0.007
927,task_927,8,20,12,8,60,0.005
928,task_928,1378,1384,6,1376,1420,0.014
929,task_929,1338,1349,11,1335,1367,0.008
930,task_930,713,725,12,713,1278,0.012
931,task_931,223,234,11,223,268,0.012
932,task_932,493,501,8,493,745,0.006
933,task_933,612,620,8,612,1244,0.011
934,task_934,250,261,11,250,1041,0.012
935,task_935,1238,1250,12,1238,1289,0.011
936,task_936,65,77,12,60,706,0.008
937,task_937,165,173,8,165,750,0.009
938,task_938,636,645,9,636,1164,0.011
939,task_939,543,548,5,492,1432,0.013
940,task_940,425,430,5,423,968,0.014
941,task_941,783,794,11,779,1212,0.011
942,task_942,373,383,10,373,677,0.014
943,task_943,1098,1107,9,1097,1342,0.011
944,task_944,394,406,12,394,1027,0.013
945,task_945,952,960,8,950,1299,0.011
946,task_946,723,731,8,723,865,0.009
947,task_947,1361,1373,12,1361,1424,0.008
948,task_948,1235,1242,7,1235,1277,0.006
949,task_949,332,344,12,331,1192,0.012
950,task_950,329,342,13,329,1365,0.009
951,task_951,872,883,11,871,1014,0.012
952,task_952,735,744,9,734,1018,0.01
953,task_953,672,679,7,672,813,0.006
954,task_954,614,624,10,614,1159,0.007
955,task_955,6,18,12,6,428,0.005
956,task_956,141,146,5,140,647,0.01
957,task_957,1139,1150,11,1132,1409,0.005
958,task_958,379,390,11,374,1078,0.011
959,task_959,883,892,9,882,995,0.012
960,task_960,960,966,6,959,1147,0.01
961,task_961,1086,1095,9,1086,1249,0.009
962,task_962,98,106,8,98,361,0.005
963,task_963,34,47,13,34,791,0.01
964,task_964,366,372,6,366,723,0.014
965,task_965,306,314,8,304,924,0.013
966,task_966,516,524,8,515,1130,0.007
967,task_967,1320,1328,8,1320,1364,0.011
968,task_968,184,198,14,184,392,0.006
969,task_969,1334,1339,5,1334,1388,0.009
970,task_970,986,993,7,877,1418,0.005
971,task_971,137,148,11,137,273,0.006
972,task_972,337,342,5,337,680,0.007
973,task_973,1125,1137,12,1125,1201,0.011
974,task_974,900,907,7,896,1234,0.014
975,task_975,664,676,12,664,703,0.008
976,task_976,101,108,7,100,1261,0.005
977,task_977,39,48,9,39,1060,0.007
978,task_978,1007,1021,14,1007,1093,0.014
979,task_979,790,804,14,788,911,0.013
980,task_980,1223,1232,9,1223,1273,0.005
981,task_981,581,587,6,581,1109,0.011
982,task_982,632,638,6,632,1114,0.005
983,task_983,818,823,5,818,1222,0.009
984,task_984,1021,1033,12,1017,1391,0.005
985,task_985,506,515,9,506,548,0.008
986,task_986,460,469,9,460,1056,0.006
987,task_987,1130,1140,10,872,1423,0.009
988,task_988,735,744,9,734,929,0.012
989,task_989,175,182,7,175,408,0.007
990,task_990,1218,1229,11,1217,1325,0.009
991,task_991,1218,1228,10,1216,1299,0.013
992,task_992,856,864,8,852,1143,0.01
993,task_993,245,255,10,245,348,0.005
994,task_994,325,332,7,325,737,0.006
995,task_995,1290,1303,13,1274,1417,0.006
996,task_996,680,690,10,680,795,0.007
997,task_997,1075,1082,7,1074,1388,0.012
998,task_998,999,1011,12,999,1183,0.006
999,task_999,990,998,8,990,1092,0.011
1000,task_1000,1367,1372,5,1365,1417,0.008
1001,task_1001,16,24,8,16,321,0.005
1002,task_1002,139,146,7,139,667,0.006
1003,task_1003,862,867,5,804,1350,0.009
1004,task_1004,803,813,10,802,1205,0.007
1005,task_1005,316,328,12,316,1161,0.01
1006,task_1006,989,1003,14,988,1162,0.006
1007,task_1007,638,645,7,638,792,0.007
1008,task_1008,620,628,8,620,669,0.009
1009,task_1009,734,744,10,734,892,0.01
1010,task_1010,504,517,13,504,830,0.007
1011,task_1011,926,940,14,926,1030,0.014
1012,task_1012,43,51,8,43,600,0.008
1013,task_1013,527,539,12,499,1379,0.005
1014,task_1014,1059,1069,10,1059,1150,0.01
1015,task_1015,1205,1218,13,1198,1416,0.014
1016,task_1016,1366,1377,11,1366,1397,0.011
1017,task_1017,522,531,9,483,1291,0.009
1018,task_1018,83,89,6,81,329,0.013
1019,task_1019,692,705,13,684,1431,0.01
1020,task_1020,1032,1042,10,1032,1081,0.006
1021,task_1021,1075,1082,7,1074,1352,0.006
1022,task_1022,553,559,6,549,1003,0.013
1023,task_1023,313,326,13,310,1173,0.009
1024,task_1024,17,30,13,17,363,0.006
1025,task_1025,956,964,8,955,1209,0.014
1026,task_1026,1125,1139,14,1124,1367,0.012
1027,task_1027,911,924,13,911,1074,0.01
1028,task_1028,616,630,14,614,1375,0.011
1029,task_1029,237,250,13,237,363,0.014
1030,task_1030,1107,1119,12,1107,1349,0.005
1031,task_1031,251,260,9,251,1033,0.005
1032,task_1032,849,858,9,831,1334,0.01
1033,task_1033,1073,1086,13,1073,1155,0.012
1034,task_1034,1016,1025,9,1012,1160,0.011
1035,task_1035,255,264,9,255,1032,0.014
1036,task_1036,1383,1397,14,1382,1437,0.007
1037,task_1037,105,117,12,104,340,0.008
1038,task_1038,883,896,13,878,1095,0.009
1039,task_1039,167,181,14,166,670,0.01
1040,task_1040,830,837,7,830,1098,0.014
1041,task_1041,135,142,7,135,724,0.006
1042,task_1042,1154,1162,8,1145,1317,0.012
1043,task_1043,1356,1361,5,1355,1407,0.01
1044,task_1044,1397,1406,9,1397,1428,0.009
1045,task_1045,733,743,10,733,1155,0.012
1046,task_1046,1244,1254,10,1205,1433,0.012
1047,task_1047,220,231,11,220,1101,0.007
1048,task_1048,1192,1197,5,1192,1263,0.005
1049,task_1049,948,957,9,943,1235,0.011
1050,task_1050,1176,1187,11,1176,1406,0.01
1051,task_1051,1345,1351,6,1345,1376,0.005
1052,task_1052,101,107,6,100,982,0.006
1053,task_1053,350,355,5,347,732,0.007
1054,task_1054,521,527,6,521,541,0.008
1055,task_1055,913,926,13,913,1252,0.009
1056,task_1056,913,920,7,913,1045,0.014
1057,task_1057,1211,1218,7,1211,1376,0.009
1058,task_1058,44,55,11,41,1357,0.009
1059,task_1059,117,125,8,117,673,0.007
1060,task_1060,838,850,12,834,1246,0.006
1061,task_1061,1303,1310,7,1302,1420,0.013
1062,task_1062,129,141,12,129,444,0.014
1063,task_1063,645,657,12,645,799,0.012
1064,task_1064,1188,1200,12,1187,1320,0.011
1065,task_1065,864,875,11,864,1072,0.005
1066,task_1066,697,707,10,695,869,0.014
1067,task_1067,204,209,5,202,311,0.013
1068,task_1068,1011,1021,10,1004,1381,0.01
1069,task_1069,1237,1243,6,1237,1258,0.014
1070,task_1070,1021,1034,13,1016,1267,0.014
1071,task_1071,1080,1091,11,1080,1140,0.007
1072,task_1072,1349,1356,7,1342,1436,0.013
1073,task_1073,32,39,7,32,1201,0.005
1074,task_1074,714,725,11,698,1307,0.009
1075,task_1075,1297,1306,9,1291,1402,0.01
1076,task_1076,277,285,8,276,951,0.005
1077,task_1077,1351,1357,6,1351,1390,0.014
1078,task_1078,1243,1251,8,1006,1430,0.006
1079,task_1079,1267,1280,13,1265,1379,0.005
1080,task_1080,863,876,13,779,1373,0.012
1081,task_1081,1027,1036,9,1024,1264,0.006
1082,task_1082,712,721,9,709,971,0.011
1083,task_1083,344,350,6,342,1177,0.011
1084,task_1084,1011,1018,7,1010,1100,0.014
1085,task_1085,664,676,12,660,969,0.013
1086,task_1086,115,120,5,115,975,0.007
1087,task_1087,253,260,7,251,1356,0.011
1088,task_1088,346,357,11,346,582,0.008
1089,task_1089,442,448,6,442,873,0.013
1090,task_1090,1081,1093,12,1077,1164,0.012
1091,task_1091,797,808,11,793,985,0.014
1092,task_1092,282,293,11,282,468,0.009
1093,task_1093,756,766,10,754,1185,0.011
1094,task_1094,889,900,11,889,1051,0.009
1095,task_1095,1290,1296,6,1284,1414,0.011
1096,task_1096,925,932,7,925,1026,0.011
1097,task_1097,850,855,5,818,1332,0.009
1098,task_1098,900,909,9,896,1210,0.009
1099,task_1099,1073,1085,12,1071,1393,0.006
1100,task_1100,190,204,14,190,1401,0.011
1101,task_1101,880,887,7,879,1011,0.012
1102,task_1102,492,498,6,481,1202,0.013
1103,task_1103,589,603,14,589,694,0.011
1104,task_1104,119,126,7,118,1432,0.011
1105,task_1105,148,162,14,147,616,0.008
1106,task_1106,321,327,6,321,604,0.008
1107,task_1107,221,228,7,221,937,0.011
1108,task_1108,1126,1134,8,1126,1282,0.014
1109,task_1109,63,74,11,61,402,0.008
1110,task_1110,728,740,12,727,811,0.012
1111,task_1111,819,826,7,819,1232,0.011
1112,task_1112,481,494,13,479,1180,0.008
1113,task_1113,691,705,14,690,1144,0.006
1114,task_1114,325,338,13,325,1133,0.005
1115,task_1115,201,210,9,201,803,0.007
1116,task_1116,1255,1267,12,1254,1436,0.013
1117,task_1117,406,413,7,361,1417,0.007
1118,task_1118,489,501,12,488,989,0.01
1119,task_1119,1151,1157,6,1146,1249,0.012
1120,task_1120,70,76,6,70,198,0.005
1121,task_1121,529,543,14,519,1427,0.012
1122,task_1122,703,712,9,697,1047,0.011
1123,task_1123,700,712,12,696,971,0.009
1124,task_1124,517,530,13,512,1221,0.013
1125,task_1125,20,34,14,20,113,0.011
1126,task_1126,260,270,10,257,946,0.008
1127,task_1127,249,259,10,248,471,0.007
1128,task_1128,793,806,13,793,889,0.01
1129,task_1129,64,70,6,62,456,0.008
1130,task_1130,900,912,12,893,1230,0.01
1131,task_1131,1227,1238,11,1226,1287,0.006
1132,task_1132,19,32,13,19,674,0.007
1133,task_1133,1196,1205,9,1196,1284,0.005
1134,task_1134,172,179,7,172,972,0.011
1135,task_1135,398,409,11,396,1169,0.009
1136,task_1136,611,620,9,611,974,0.014
1137,task_1137,898,907,9,897,1116,0.005
1138,task_1138,684,692,8,684,1340,0.011
1139,task_1139,1190,1195,5,1189,1243,0.013
1140,task_1140,13,27,14,13,192,0.011
1141,task_1141,700,706,6,700,745,0.012
1142,task_1142,937,946,9,936,1001,0.005
1143,task_1143,1125,1138,13,1125,1196,0.01
1144,task_1144,1066,1078,12,1059,1385,0.005
1145,task_1145,63,74,11,61,416,0.011
1146,task_1146,280,288,8,280,470,0.008
1147,task_1147,660,671,11,660,716,0.007
1148,task_1148,915,920,5,915,946,0.014
1149,task_1149,1394,1404,10,1394,1426,0.012
1150,task_1150,1062,1076,14,1062,1093,0.006
1151,task_1151,515,522,7,514,1007,0.006
1152,task_1152,1078,1088,10,1078,1102,0.012
1153,task_1153,1229,1237,8,1229,1297,0.005
1154,task_1154,399,405,6,356,1324,0.01
1155,task_1155,980,987,7,979,1385,0.006
1156,task_1156,383,396,13,381,845,0.012
1157,task_1157,512,518,6,510,649,0.014
1158,task_1158,400,408,8,389,1344,0.012
1159,task_1159,311,318,7,310,467,0.013
1160,task_1160,318,323,5,317,1373,0.005
1161,task_1161,1037,1051,14,1027,1325,0.014
1162,task_1162,573,586,13,573,675,0.01
1163,task_1163,1192,1199,7,1192,1223,0.005
1164,task_1164,763,774,11,763,834,0.009
1165,task_1165,1306,1319,13,1267,1438,0.012
1166,task_1166,838,849,11,830,1229,0.005
1167,task_1167,1386,1397,11,1385,1412,0.006
1168,task_1168,1367,1375,8,1365,1408,0.006
1169,task_1169,519,527,8,488,1284,0.013
1170,task_1170,585,590,5,585,1303,0.014
1171,task_1171,1122,1134,12,1047,1415,0.012
1172,task_1172,722,736,14,722,1295,0.01
1173,task_1173,1274,1279,5,1274,1301,0.008
1174,task_1174,1384,1393,9,1384,1408,0.005
1175,task_1175,215,226,11,215,548,0.01
1176,task_1176,1040,1045,5,1039,1156,0.01
1177,task_1177,1070,1078,8,1070,1259,0.01
1178,task_1178,221,228,7,221,387,0.008
1179,task_1179,892,901,9,879,1350,0.006
1180,task_1180,334,346,12,334,510,0.014
1181,task_1181,1234,1246,12,1187,1430,0.005
1182,task_1182,478,490,12,478,614,0.014
1183,task_1183,764,777,13,763,965,0.009
1184,task_1184,1174,1187,13,1172,1286,0.014
1185,task_1185,1004,1016,12,1004,1082,0.007
1186,task_1186,7,16,9,7,838,0.009
1187,task_1187,777,787,10,776,991,0.009
1188,task_1188,1268,1276,8,1268,1362,0.007
1189,task_1189,676,687,11,676,1042,0.007
1190,task_1190,934,941,7,934,1104,0.007
1191,task_1191,4,13,9,4,259,0.011
1192,task_1192,1025,1034,9,1024,1258,0.009
1193,task_1193,976,983,7,976,1115,0.011
1194,task_1194,814,824,10,796,1316,0.008
1195,task_1195,351,359,8,348,950,0.006
1196,task_1196,419,431,12,414,1288,0.014
1197,task_1197,1030,1035,5,1024,1308,0.012
1198,task_1198,126,133,7,122,1285,0.011
1199,task_1199,976,989,13,933,1397,0.011
1200,task_1200,1315,1327,12,1314,1436,0.01
1201,task_1201,187,201,14,187,814,0.005
1202,task_1202,1003,1015,12,1003,1249,0.006
1203,task_1203,185,193,8,185,1207,0.013
1204,task_1204,929,940,11,927,1082,0.012
1205,task_1205,518,524,6,518,1246,0.005
1206,task_1206,1286,1293,7,1283,1352,0.014
1207,task_1207,571,579,8,570,1105,0.006
1208,task_1208,1223,1237,14,1223,1275,0.006
1209,task_1209,1107,1116,9,1107,1203,0.009
1210,task_1210,298,307,9,298,901,0.012
1211,task_1211,740,754,14,740,1296,0.013
1212,task_1212,56,69,13,56,1369,0.006
1213,task_1213,1233,1240,7,1232,1397,0.014
1214,task_1214,622,635,13,617,1340,0.011
1215,task_1215,1200,1208,8,1196,1377,0.014
1216,task_1216,111,117,6,108,1297,0.01
1217,task_1217,1181,1187,6,1181,1373,0.008
1218,task_1218,873,882,9,873,1330,0.008
1219,task_1219,517,522,5,517,608,0.006
1220,task_1220,466,476,10,463,1101,0.012
1221,task_1221,589,601,12,589,1069,0.007
1222,task_1222,1086,1094,8,1082,1264,0.011
1223,task_1223,1322,1334,12,1320,1420,0.01
1224,task_1224,1069,1075,6,1068,1268,0.008
1225,task_1225,261,275,14,258,1009,0.01
1226,task_1226,691,697,6,670,1420,0.007
1227,task_1227,837,851,14,834,1206,0.005
1228,task_1228,488,494,6,488,761,0.013
1229,task_1229,974,984,10,956,1376,0.006
1230,task_1230,857,863,6,856,1144,0.014
1231,task_1231,993,1007,14,992,1316,0.011
1232,task_1232,964,976,12,956,1353,0.006
1233,task_1233,183,188,5,183,1077,0.007
1234,task_1234,613,624,11,613,1034,0.009
1235,task_1235,1092,1099,7,1092,1157,0.01
1236,task_1236,887,892,5,883,1300,0.012
1237,task_1237,78,83,5,78,962,0.009
1238,task_1238,753,767,14,752,993,0.006
1239,task_1239,1338,1344,6,1337,1392,0.006
1240,task_1240,1101,1106,5,1101,1161,0.008
1241,task_1241,1134,1143,9,1134,1225,0.008
1242,task_1242,1164,1178,14,1164,1291,0.008
1243,task_1243,753,763,10,750,1081,0.007
1244,task_1244,1251,1257,6,1249,1382,0.009
1245,task_1245,842,847,5,842,893,0.011
1246,task_1246,678,686,8,678,823,0.008
1247,task_1247,540,552,12,539,907,0.013
1248,task_1248,858,863,5,853,1237,0.011
1249,task_1249,560,571,11,559,1038,0.013
1250,task_1250,406,419,13,393,1422,0.006
1251,task_1251,142,155,13,142,303,0.007
1252,task_1252,135,148,13,135,777,0.013
1253,task_1253,291,298,7,291,757,0.007
1254,task_1254,137,144,7,136,925,0.005
1255,task_1255,448,460,12,448,737,0.011
1256,task_1256,128,141,13,128,1076,0.007
1257,task_1257,37,42,5,37,1324,0.012
1258,task_1258,975,985,10,975,1197,0.005
1259,task_1259,601,610,9,601,1253,0.011
1260,task_1260,1279,1290,11,1279,1408,0.01
1261,task_1261,953,962,9,946,1314,0.006
1262,task_1262,1209,1222,13,1090,1427,0.012
1263,task_1263,546,559,13,546,626,0.014
1264,task_1264,789,801,12,789,814,0.007
1265,task_1265,1154,1163,9,1149,1355,0.006
1266,task_1266,305,313,8,302,896,0.005
1267,task_1267,380,387,7,377,1123,0.014
1268,task_1268,1290,1304,14,1278,1417,0.014
1269,task_1269,829,837,8,829,1026,0.007
1270,task_1270,1051,1060,9,1049,1187,0.011
1271,task_1271,1137,1151,14,1137,1288,0.013
1272,task_1272,1112,1123,11,1111,1247,0.007
1273,task_1273,75,86,11,75,270,0.013
1274,task_1274,1021,1030,9,1014,1335,0.011
1275,task_1275,1178,1191,13,1169,1416,0.007
1276,task_1276,898,910,12,895,1110,0.005
1277,task_1277,42,52,10,41,895,0.007
1278,task_1278,952,965,13,949,1273,0.008
1279,task_1279,331,343,12,330,1006,0.012
1280,task_1280,968,973,5,966,1286,0.011
1281,task_1281,205,215,10,199,1019,0.013
1282,task_1282,249,261,12,248,469,0.01
1283,task_1283,272,283,11,265,1054,0.006
1284,task_1284,264,274,10,264,544,0.011
1285,task_1285,98,111,13,98,1097,0.012
1286,task_1286,125,133,8,125,754,0.01
1287,task_1287,324,331,7,324,1128,0.005
1288,task_1288,134,148,14,134,1175,0.009
1289,task_1289,426,435,9,328,1432,0.005
1290,task_1290,719,728,9,718,1187,0.014
1291,task_1291,596,605,9,596,1219,0.006
1292,task_1292,422,435,13,422,1010,0.011
1293,task_1293,910,920,10,910,1385,0.007
1294,task_1294,1218,1225,7,1216,1288,0.008
1295,task_1295,631,641,10,631,1265,0.011
1296,task_1296,492,506,14,486,1220,0.012
1297,task_1297,703,712,9,703,1220,0.008
1298,task_1298,980,989,9,970,1393,0.009
1299,task_1299,274,286,12,272,1356,0.013
1300,task_1300,237,247,10,237,532,0.008
1301,task_1301,890,898,8,890,1071,0.012
1302,task_1302,1020,1033,13,1019,1230,0.013
1303,task_1303,204,218,14,200,1007,0.009
1304,task_1304,305,317,12,305,568,0.005
1305,task_1305,266,272,6,262,627,0.012
1306,task_1306,388,399,11,383,1197,0.008
1307,task_1307,1176,1183,7,1176,1315,0.006
1308,task_1308,1364,1375,11,1364,1424,0.009
1309,task_1309,1096,1107,11,1088,1376,0.007
1310,task_1310,161,175,14,161,532,0.011
1311,task_1311,237,251,14,237,1089,0.013
1312,task_1312,1187,1193,6,1186,1285,0.011
1313,task_1313,1294,1301,7,1294,1349,0.006
1314,task_1314,300,306,6,300,538,0.012
1315,task_1315,181,188,7,181,540,0.007
1316,task_1316,212,217,5,212,972,0.011
1317,task_1317,957,968,11,956,1273,0.011
1318,task_1318,843,857,14,842,1165,0.013
1319,task_1319,606,616,10,606,1015,0.011
1320,task_1320,820,833,13,820,1112,0.009
1321,task_1321,1362,1372,10,1362,1384,0.007
1322,task_1322,348,356,8,348,429,0.012
1323,task_1323,512,517,5,511,782,0.009
1324,task_1324,156,167,11,155,595,0.008
1325,task_1325,956,964,8,955,1252,0.005
1326,task_1326,60,66,6,60,349,0.006
1327,task_1327,976,986,10,891,1393,0.012
1328,task_1328,644,655,11,643,1390,0.008
1329,task_1329,960,968,8,958,1262,0.011
1330,task_1330,1380,1389,9,1380,1400,0.011
1331,task_1331,80,93,13,80,396,0.01
1332,task_1332,269,279,10,262,708,0.012
1333,task_1333,1088,1093,5,1085,1274,0.006
1334,task_1334,856,867,11,853,1118,0.013
1335,task_1335,1341,1350,9,1336,1416,0.012
1336,task_1336,938,948,10,925,1301,0.006
1337,task_1337,186,195,9,186,516,0.011
1338,task_1338,1202,1214,12,1202,1304,0.007
1339,task_1339,306,312,6,302,937,0.013
1340,task_1340,1178,1189,11,1169,1412,0.005
1341,task_1341,475,487,12,475,1423,0.009
1342,task_1342,390,396,6,387,1317,0.013
1343,task_1343,952,961,9,950,1098,0.006
1344,task_1344,926,937,11,926,1018,0.009
1345,task_1345,667,679,12,667,1308,0.009
1346,task_1346,1364,1369,5,1364,1388,0.012
1347,task_1347,1197,1207,10,1196,1295,0.005
1348,task_1348,89,101,12,89,971,0.011
1349,task_1349,711,721,10,710,763,0.005
1350,task_1350,1038,1051,13,1038,1212,0.014
1351,task_1351,712,723,11,712,933,0.01
1352,task_1352,1172,1180,8,1172,1251,0.006
1353,task_1353,568,577,9,562,1409,0.012
1354,task_1354,784,797,13,784,861,0.008
1355,task_1355,654,667,13,651,974,0.011
1356,task_1356,945,957,12,945,1064,0.01
1357,task_1357,800,810,10,797,1059,0.014
1358,task_1358,1020,1034,14,1013,1212,0.005
1359,task_1359,431,444,13,431,772,0.011
1360,task_1360,320,333,13,319,1101,0.005
1361,task_1361,1167,1181,14,1155,1389,0.005
1362,task_1362,223,234,11,223,535,0.009
1363,task_1363,616,621,5,616,1141,0.01
1364,task_1364,283,293,10,280,943,0.006
1365,task_1365,1281,1287,6,1281,1334,0.009
1366,task_1366,105,115,10,104,347,0.005
1367,task_1367,1359,1365,6,1359,1412,0.005
1368,task_1368,127,137,10,127,1252,0.014
1369,task_1369,99,110,11,99,747,0.007
1370,task_1370,544,554,10,544,747,0.012
1371,task_1371,792,803,11,789,979,0.007
1372,task_1372,58,65,7,57,232,0.012
1373,task_1373,762,772,10,754,1329,0.013
1374,task_1374,680,687,7,680,887,0.01
1375,task_1375,1198,1203,5,1195,1317,0.007
1376,task_1376,1384,1393,9,1383,1436,0.013
1377,task_1377,270,283,13,268,948,0.014
1378,task_1378,725,737,12,717,1368,0.007
1379,task_1379,644,649,5,644,1221,0.011
1380,task_1380,1187,1193,6,1187,1278,0.009
1381,task_1381,293,302,9,293,603,0.011
1382,task_1382,12,21,9,12,1157,0.01
1383,task_1383,10,17,7,10,152,0.014
1384,task_1384,906,913,7,905,1203,0.006
1385,task_1385,630,643,13,630,1198,0.006
1386,task_1386,692,703,11,692,1432,0.014
1387,task_1387,629,635,6,629,884,0.011
1388,task_1388,1222,1227,5,1222,1237,0.01
1389,task_1389,898,909,11,898,1067,0.013
1390,task_1390,996,1009,13,994,1128,0.007
1391,task_1391,357,366,9,357,985,0.009
1392,task_1392,912,922,10,912,1063,0.008
1393,task_1393,977,983,6,977,1386,0.011
1394,task_1394,188,198,10,188,966,0.005
1395,task_1395,338,350,12,337,1134,0.014
1396,task_1396,545,554,9,545,627,0.007
1397,task_1397,161,172,11,159,564,0.012
1398,task_1398,1151,1161,10,1151,1300,0.011
1399,task_1399,139,150,11,137,978,0.009
1400,task_1400,546,560,14,546,1279,0.01
1401,task_1401,903,911,8,902,984,0.009
1402,task_1402,486,493,7,486,1116,0.009
1403,task_1403,53,58,5,53,377,0.011
1404,task_1404,183,197,14,183,1076,0.009
1405,task_1405,1124,1131,7,1123,1146,0.013
1406,task_1406,265,274,9,262,595,0.007
1407,task_1407,382,393,11,382,751,0.008
1408,task_1408,1368,1381,13,1368,1394,0.014
1409,task_1409,219,231,12,219,993,0.006
1410,task_1410,875,880,5,875,1218,0.009
1411,task_1411,148,154,6,143,1282,0.009
1412,task_1412,1048,1060,12,1040,1296,0.012
1413,task_1413,28,38,10,28,728,0.01
1414,task_1414,524,533,9,523,907,0.009
1415,task_1415,1073,1083,10,1042,1389,0.012
1416,task_1416,3,9,6,3,206,0.012
1417,task_1417,990,1003,13,990,1057,0.008
1418,task_1418,181,194,13,181,687,0.012
1419,task_1419,1330,1344,14,1327,1438,0.009
1420,task_1420,1050,1060,10,1049,1177,0.012
1421,task_1421,1127,1140,13,1127,1236,0.013
1422,task_1422,355,362,7,355,733,0.008
1423,task_1423,1271,1285,14,1270,1354,0.011
1424,task_1424,756,770,14,751,1189,0.007
1425,task_1425,148,156,8,147,1178,0.008
1426,task_1426,146,157,11,145,334,0.014
1427,task_1427,1358,1363,5,671,1438,0.012
1428,task_1428,938,952,14,936,1131,0.013
1429,task_1429,984,991,7,984,1132,0.01
1430,task_1430,749,755,6,748,910,0.008
1431,task_1431,772,780,8,767,1205,0.009
1432,task_1432,405,411,6,387,1401,0.005
1433,task_1433,272,282,10,272,995,0.007
1434,task_1434,120,134,14,120,1110,0.012
1435,task_1435,813,818,5,812,1292,0.005
1436,task_1436,582,593,11,582,961,0.008
1437,task_1437,159,164,5,159,387,0.01
1438,task_1438,1222,1227,5,1216,1416,0.011
1439,task_1439,693,700,7,693,818,0.007
1440,task_1440,393,405,12,393,443,0.005
1441,task_1441,770,781,11,770,1076,0.007
1442,task_1442,355,362,7,355,516,0.012
1443,task_1443,437,446,9,436,1160,0.005
1444,task_1444,221,228,7,221,1211,0.006
1445,task_1445,1307,1315,8,1307,1392,0.011
1446,task_1446,869,880,11,860,1387,0.012
1447,task_1447,1378,1385,7,1378,1431,0.006
1448,task_1448,948,962,14,947,1135,0.009
1449,task_1449,781,786,5,778,1047,0.014
1450,task_1450,1330,1340,10,1322,1430,0.014
1451,task_1451,466,471,5,465,1209,0.006
1452,task_1452,1304,1312,8,1304,1325,0.011
1453,task_1453,1372,1380,8,1371,1399,0.007
1454,task_1454,1065,1070,5,1035,1353,0.01
1455,task_1455,854,868,14,853,882,0.012
1456,task_1456,691,702,11,691,885,0.006
1457,task_1457,355,366,11,348,1201,0.01
1458,task_1458,111,122,11,111,1202,0.006
1459,task_1459,546,560,14,546,1068,0.005
1460,task_1460,409,417,8,408,862,0.011
1461,task_1461,86,98,12,85,399,0.014
1462,task_1462,433,444,11,432,596,0.009
1463,task_1463,111,121,10,108,1304,0.006
1464,task_1464,806,816,10,793,1220,0.01
1465,task_1465,427,436,9,427,641,0.005
1466,task_1466,659,667,8,652,1291,0.008
1467,task_1467,345,351,6,345,1043,0.009
1468,task_1468,46,51,5,45,1016,0.012
1469,task_1469,241,254,13,241,1365,0.009
1470,task_1470,679,686,7,678,1058,0.009
1471,task_1471,1289,1296,7,1287,1407,0.008
1472,task_1472,1185,1199,14,1183,1220,0.011
1473,task_1473,787,792,5,760,1361,0.01
1474,task_1474,372,379,7,363,1277,0.01
1475,task_1475,687,693,6,687,1224,0.007
1476,task_1476,905,918,13,904,1166,0.007
1477,task_1477,606,613,7,606,1128,0.013
1478,task_1478,411,417,6,411,1031,0.013
1479,task_1479,1349,1361,12,1349,1423,0.005
1480,task_1480,911,921,10,911,1173,0.006
1481,task_1481,1267,1278,11,1266,1386,0.008
1482,task_1482,1253,1263,10,1253,1389,0.008
1483,task_1483,1085,1098,13,1084,1143,0.007
1484,task_1484,177,189,12,177,1069,0.01
1485,task_1485,607,621,14,607,784,0.008
1486,task_1486,1150,1164,14,1150,1253,0.01
1487,task_1487,619,628,9,619,931,0.013
1488,task_1488,1079,1087,8,1078,1112,0.01
1489,task_1489,725,732,7,725,1180,0.008
1490,task_1490,522,536,14,521,1132,0.011
1491,task_1491,151,156,5,151,576,0.011
1492,task_1492,1270,1280,10,1270,1307,0.01
1493,task_1493,1383,1388,5,1382,1402,0.005
1494,task_1494,1141,1151,10,1141,1174,0.007
1495,task_1495,257,265,8,257,507,0.008
1496,task_1496,920,929,9,918,1220,0.005
1497,task_1497,691,700,9,689,1365,0.008
1498,task_1498,1096,1101,5,1079,1331,0.009
1499,task_1499,109,123,14,108,618,0.014
1500,task_1500,396,404,8,396,919,0.01
1501,task_1501,504,517,13,503,1246,0.013
1502,task_1502,536,550,14,493,1437,0.013
1503,task_1503,225,236,11,225,912,0.007
1504,task_1504,189,197,8,189,1057,0.011
1505,task_1505,726,734,8,726,1102,0.009
1506,task_1506,1287,1292,5,1287,1308,0.007
1507,task_1507,183,190,7,183,663,0.012
1508,task_1508,228,238,10,225,1383,0.01
1509,task_1509,1240,1245,5,1235,1420,0.013
1510,task_1510,326,338,12,324,1235,0.009
1511,task_1511,474,488,14,474,956,0.01
1512,task_1512,288,294,6,288,1132,0.013
1513,task_1513,5,10,5,5,1023,0.011
1514,task_1514,222,230,8,222,360,0.007
1515,task_1515,1362,1375,13,1362,1389,0.007
1516,task_1516,219,228,9,219,387,0.006
1517,task_1517,963,971,8,954,1341,0.011
1518,task_1518,1138,1151,13,1134,1369,0.008
1519,task_1519,813,823,10,796,1312,0.006
1520,task_1520,748,758,10,748,879,0.011
1521,task_1521,1238,1244,6,1237,1359,0.005
1522,task_1522,1060,1066,6,1048,1330,0.014
1523,task_1523,1393,1404,11,1390,1436,0.008
1524,task_1524,1082,1091,9,1078,1217,0.009
1525,task_1525,172,182,10,172,276,0.012
1526,task_1526,266,280,14,265,671,0.007
1527,task_1527,1174,1188,14,1173,1333,0.013
1528,task_1528,10,20,10,10,1048,0.012
1529,task_1529,851,856,5,832,1347,0.008
1530,task_1530,84,97,13,83,882,0.013
1531,task_1531,823,828,5,822,922,0.011
1532,task_1532,858,864,6,858,1329,0.008
1533,task_1533,850,858,8,829,1345,0.01
1534,task_1534,1179,1188,9,1179,1213,0.007
1535,task_1535,1064,1078,14,1062,1333,0.005
1536,task_1536,14,24,10,14,916,0.009
1537,task_1537,560,566,6,556,1035,0.008
1538,task_1538,246,252,6,246,853,0.005
1539,task_1539,1035,1048,13,1035,1153,0.005
1540,task_1540,1271,1277,6,1271,1299,0.007
1541,task_1541,1342,1353,11,1331,1427,0.008
1542,task_1542,459,467,8,459,1185,0.008
1543,task_1543,1247,1253,6,1247,1397,0.005
1544,task_1544,1339,1345,6,1339,1393,0.005
1545,task_1545,294,301,7,293,1134,0.006
1546,task_1546,341,355,14,340,748,0.008
1547,task_1547,588,601,13,588,855,0.006
1548,task_1548,1280,1294,14,1280,1341,0.007
1549,task_1549,323,330,7,323,1246,0.008
1550,task_1550,360,370,10,358,1187,0.009
1551,task_1551,531,542,11,531,772,0.011
1552,task_1552,485,491,6,483,773,0.007
1553,task_1553,148,155,7,145,1248,0.01
1554,task_1554,156,167,11,152,567,0.006
1555,task_1555,1308,1319,11,1307,1425,0.009
1556,task_1556,606,619,13,606,1284,0.013
1557,task_1557,357,363,6,357,847,0.007
1558,task_1558,650,658,8,650,828,0.007
1559,task_1559,1321,1334,13,1321,1410,0.011
1560,task_1560,788,794,6,788,888,0.006
1561,task_1561,264,274,10,262,533,0.012
1562,task_1562,1400,1408,8,1398,1439,0.006
1563,task_1563,444,449,5,421,1429,0.01
1564,task_1564,920,929,9,920,1221,0.008
1565,task_1565,612,626,14,612,1151,0.012
1566,task_1566,1312,1320,8,1312,1350,0.014
1567,task_1567,150,156,6,149,289,0.013
1568,task_1568,1158,1165,7,1156,1343,0.01
1569,task_1569,178,184,6,178,1013,0.005
1570,task_1570,867,872,5,867,1193,0.014
1571,task_1571,274,287,13,263,1368,0.013
1572,task_1572,781,792,11,776,1057,0.009
1573,task_1573,1283,1290,7,1283,1332,0.014
1574,task_1574,1369,1377,8,1369,1413,0.008
1575,task_1575,1045,1057,12,1043,1238,0.013
1576,task_1576,847,861,14,828,1328,0.011
1577,task_1577,962,970,8,961,1192,0.006
1578,task_1578,1248,1258,10,1248,1291,0.012
1579,task_1579,622,631,9,620,1352,0.008
1580,task_1580,137,150,13,136,689,0.013
1581,task_1581,518,523,5,518,1131,0.007
1582,task_1582,1065,1076,11,1023,1343,0.007
1583,task_1583,56,66,10,56,400,0.009
1584,task_1584,336,341,5,336,760,0.011
1585,task_1585,1214,1227,13,736,1427,0.011
1586,task_1586,501,507,6,499,1249,0.012
1587,task_1587,770,784,14,770,856,0.009
1588,task_1588,1290,1300,10,1289,1419,0.008
1589,task_1589,780,792,12,774,996,0.013
1590,task_1590,478,485,7,478,1359,0.007
1591,task_1591,76,84,8,76,847,0.012
1592,task_1592,1362,1373,11,1362,1434,0.006
1593,task_1593,1345,1358,13,1344,1429,0.013
1594,task_1594,823,837,14,822,961,0.005
1595,task_1595,313,318,5,306,1183,0.008
1596,task_1596,422,430,8,415,1358,0.006
1597,task_1597,287,297,10,278,1323,0.008
1598,task_1598,89,99,10,79,1153,0.014
1599,task_1599,559,571,12,557,729,0.007
1600,task_1600,682,693,11,682,789,0.006
1601,task_1601,75,80,5,75,1005,0.011
1602,task_1602,909,915,6,901,1326,0.014
1603,task_1603,509,515,6,506,1272,0.012
1604,task_1604,661,673,12,661,714,0.011
1605,task_1605,1057,1064,7,1057,1105,0.009
1606,task_1606,731,740,9,730,792,0.006
1607,task_1607,169,179,10,169,879,0.007
1608,task_1608,297,311,14,297,942,0.008
1609,task_1609,915,922,7,884,1382,0.01
1610,task_1610,692,701,9,692,920,0.008
1611,task_1611,1278,1286,8,1273,1408,0.007
1612,task_1612,155,167,12,152,311,0.012
1613,task_1613,204,213,9,203,779,0.008
1614,task_1614,696,708,12,696,860,0.012
1615,task_1615,942,948,6,938,1320,0.012
1616,task_1616,411,417,6,410,488,0.012
1617,task_1617,155,161,6,153,504,0.012
1618,task_1618,1302,1315,13,1283,1424,0.013
1619,task_1619,476,483,7,476,653,0.006
1620,task_1620,971,980,9,969,1348,0.008
1621,task_1621,387,400,13,381,1180,0.012
1622,task_1622,533,542,9,532,1312,0.011
1623,task_1623,1288,1297,9,1288,1343,0.006
1624,task_1624,1377,1384,7,1377,1402,0.007
1625,task_1625,536,544,8,535,1430,0.012
1626,task_1626,122,129,7,121,605,0.013
1627,task_1627,86,98,12,86,468,0.013
1628,task_1628,1365,1375,10,1365,1388,0.01
1629,task_1629,1236,1248,12,1236,1302,0.007
1630,task_1630,1350,1356,6,1285,1435,0.008
1631,task_1631,194,201,7,194,682,0.011
1632,task_1632,726,733,7,720,1405,0.012
1633,task_1633,37,45,8,37,869,0.005
1634,task_1634,1161,1173,12,1159,1219,0.008
1635,task_1635,1367,1380,13,1366,1421,0.008
1636,task_1636,304,315,11,302,766,0.011
1637,task_1637,891,901,10,890,1212,0.011
1638,task_1638,492,498,6,483,1206,0.01
1639,task_1639,1060,1068,8,1023,1332,0.005
1640,task_1640,577,583,6,577,938,0.011
1641,task_1641,782,793,11,776,1186,0.008
1642,task_1642,1340,1352,12,1340,1405,0.012
1643,task_1643,629,638,9,629,1256,0.009
1644,task_1644,474,481,7,474,997,0.01
1645,task_1645,1045,1055,10,1045,1293,0.007
1646,task_1646,1363,1374,11,1363,1435,0.011
1647,task_1647,259,269,10,257,865,0.013
1648,task_1648,810,819,9,810,1064,0.008
1649,task_1649,1202,1212,10,1194,1408,0.01
1650,task_1650,879,887,8,877,931,0.012
1651,task_1651,1373,1383,10,1372,1421,0.014
1652,task_1652,1257,1267,10,796,1435,0.013
1653,task_1653,876,886,10,874,1382,0.007
1654,task_1654,1287,1301,14,1280,1364,0.014
1655,task_1655,1170,1178,8,1170,1329,0.009
1656,task_1656,838,845,7,825,1260,0.012
1657,task_1657,307,313,6,306,1157,0.005
1658,task_1658,1152,1165,13,1152,1221,0.014
1659,task_1659,376,389,13,374,807,0.007
1660,task_1660,73,86,13,73,600,0.006
1661,task_1661,1375,1388,13,1375,1434,0.008
1662,task_1662,417,425,8,416,733,0.012
1663,task_1663,215,229,14,215,330,0.005
1664,task_1664,1200,1207,7,1191,1399,0.008
1665,task_1665,1294,1305,11,1294,1373,0.006
1666,task_1666,107,112,5,102,837,0.008
1667,task_1667,1330,1338,8,1329,1411,0.006
1668,task_1668,728,735,7,727,1173,0.008
1669,task_1669,786,800,14,784,1303,0.01
1670,task_1670,1266,1273,7,1266,1346,0.007
1671,task_1671,342,353,11,342,441,0.013
1672,task_1672,1075,1082,7,1074,1226,0.011
1673,task_1673,252,265,13,252,403,0.005
1674,task_1674,1151,1163,12,1145,1307,0.013
1675,task_1675,1290,1302,12,1274,1416,0.009
1676,task_1676,1008,1020,12,1008,1262,0.006
1677,task_1677,867,879,12,867,936,0.006
1678,task_1678,924,938,14,924,1296,0.014
1679,task_1679,473,485,12,473,1438,0.005
1680,task_1680,1375,1381,6,1372,1426,0.011
1681,task_1681,1083,1089,6,1081,1221,0.013
1682,task_1682,1008,1020,12,1008,1105,0.013
1683,task_1683,388,401,13,388,1257,0.008
1684,task_1684,1364,1378,14,1364,1423,0.013
1685,task_1685,810,824,14,795,1239,0.014
1686,task_1686,417,422,5,417,688,0.01
1687,task_1687,222,236,14,222,701,0.006
1688,task_1688,360,371,11,358,1185,0.006
1689,task_1689,401,406,5,401,767,0.005
1690,task_1690,16,28,12,16,731,0.006
1691,task_1691,1111,1118,7,1111,1148,0.012
1692,task_1692,425,431,6,423,1192,0.005
1693,task_1693,287,293,6,278,1260,0.014
1694,task_1694,508,513,5,506,1210,0.013
1695,task_1695,572,578,6,572,1007,0.007
1696,task_1696,1301,1312,11,1300,1405,0.007
1697,task_1697,244,254,10,244,541,0.006
1698,task_1698,575,586,11,575,1033,0.011
1699,task_1699,456,468,12,456,1402,0.012
1700,task_1700,838,850,12,837,1212,0.011
1701,task_1701,805,814,9,805,1019,0.008
1702,task_1702,522,528,6,501,1305,0.011
1703,task_1703,97,105,8,60,1243,0.007
1704,task_1704,1393,1407,14,1392,1425,0.005
1705,task_1705,931,945,14,926,1186,0.008
1706,task_1706,679,693,14,674,1287,0.014
1707,task_1707,804,813,9,804,850,0.006
1708,task_1708,1331,1345,14,1331,1372,0.009
1709,task_1709,1274,1284,10,1274,1337,0.011
1710,task_1710,690,695,5,689,990,0.005
1711,task_1711,1116,1125,9,1116,1306,0.007
1712,task_1712,538,545,7,537,1329,0.011
1713,task_1713,417,425,8,414,1210,0.005
1714,task_1714,1165,1170,5,1147,1367,0.013
1715,task_1715,1005,1011,6,1005,1367,0.01
1716,task_1716,400,405,5,377,1342,0.006
1717,task_1717,513,519,6,510,963,0.007
1718,task_1718,287,300,13,287,1357,0.005
1719,task_1719,1034,1048,14,1031,1163,0.014
1720,task_1720,460,465,5,460,1219,0.009
1721,task_1721,1134,1143,9,1133,1360,0.006
1722,task_1722,707,715,8,707,1127,0.014
1723,task_1723,1065,1073,8,1025,1359,0.008
1724,task_1724,515,522,7,513,1063,0.014
1725,task_1725,497,503,6,496,525,0.01
1726,task_1726,880,892,12,880,906,0.01
1727,task_1727,305,317,12,300,807,0.012
1728,task_1728,731,738,7,729,1275,0.011
1729,task_1729,640,654,14,640,867,0.01
1730,task_1730,679,684,5,679,835,0.008
1731,task_1731,932,941,9,932,998,0.005
1732,task_1732,1051,1065,14,1049,1314,0.012
1733,task_1733,430,439,9,430,1270,0.006
1734,task_1734,34,46,12,34,973,0.007
1735,task_1735,771,783,12,763,1106,0.012
1736,task_1736,912,917,5,912,1023,0.006
1737,task_1737,1185,1195,10,1184,1266,0.007
1738,task_1738,326,332,6,326,1338,0.013
1739,task_1739,164,173,9,164,456,0.005
1740,task_1740,1227,1237,10,775,1426,0.009
1741,task_1741,1262,1271,9,1262,1344,0.005
1742,task_1742,1208,1222,14,1208,1378,0.005
1743,task_1743,23,32,9,23,640,0.007
1744,task_1744,1199,1208,9,1197,1358,0.012
1745,task_1745,1372,1384,12,1370,1419,0.011
1746,task_1746,722,733,11,722,1020,0.01
1747,task_1747,67,78,11,67,421,0.01
1748,task_1748,983,997,14,729,1399,0.009
1749,task_1749,350,360,10,348,640,0.009
1750,task_1750,1033,1047,14,1032,1091,0.011
1751,task_1751,837,849,12,835,1027,0.012
1752,task_1752,815,828,13,815,975,0.014
1753,task_1753,621,627,6,621,952,0.009
1754,task_1754,1002,1016,14,1001,1200,0.009
1755,task_1755,222,231,9,222,631,0.006
1756,task_1756,640,650,10,640,1205,0.012
1757,task_1757,1381,1389,8,1379,1405,0.01
1758,task_1758,505,512,7,480,1265,0.011
1759,task_1759,1106,1115,9,1106,1298,0.012
1760,task_1760,765,776,11,765,965,0.01
1761,task_1761,1326,1340,14,1320,1433,0.012
1762,task_1762,293,298,5,292,569,0.014
1763,task_1763,466,478,12,462,1030,0.008
1764,task_1764,1243,1255,12,1243,1432,0.01
1765,task_1765,920,931,11,916,1134,0.01
1766,task_1766,595,605,10,595,1373,0.011
1767,task_1767,1359,1368,9,1359,1381,0.01
1768,task_1768,656,667,11,649,1135,0.005
1769,task_1769,494,500,6,492,1241,0.012
1770,task_1770,1144,1156,12,1144,1317,0.01
1771,task_1771,975,986,11,957,1377,0.01
1772,task_1772,310,322,12,310,413,0.005
1773,task_1773,813,819,6,812,1192,0.009
1774,task_1774,789,801,12,789,886,0.006
1775,task_1775,823,832,9,823,908,0.011
1776,task_1776,173,182,9,173,264,0.011
1777,task_1777,124,135,11,124,862,0.012
1778,task_1778,197,211,14,194,1225,0.012
1779,task_1779,185,193,8,185,571,0.007
1780,task_1780,456,464,8,456,784,0.009
1781,task_1781,193,207,14,192,1000,0.007
1782,task_1782,1036,1050,14,1036,1289,0.008
1783,task_1783,837,846,9,823,1205,0.011
1784,task_1784,273,287,14,273,845,0.011
1785,task_1785,1156,1162,6,1156,1186,0.005
1786,task_1786,1287,1298,11,1285,1371,0.007
1787,task_1787,51,59,8,51,1326,0.009
1788,task_1788,629,638,9,629,1357,0.01
1789,task_1789,1258,1268,10,1258,1328,0.005
1790,task_1790,1036,1041,5,1036,1238,0.005
1791,task_1791,608,614,6,608,973,0.01
1792,task_1792,1107,1112,5,1107,1207,0.009
1793,task_1793,0,11,11,0,1370,0.009
1794,task_1794,451,460,9,451,669,0.014
1795,task_1795,1389,1400,11,1385,1432,0.012
1796,task_1796,564,571,7,560,1129,0.012
1797,task_1797,850,862,12,850,959,0.011
1798,task_1798,1247,1255,8,1246,1330,0.006
1799,task_1799,53,67,14,53,733,0.008
1800,task_1800,667,674,7,653,1375,0.009
1801,task_1801,30,38,8,30,419,0.007
1802,task_1802,1115,1125,10,1113,1331,0.011
1803,task_1803,353,360,7,353,1117,0.01
1804,task_1804,675,681,6,672,982,0.007
1805,task_1805,649,660,11,647,801,0.007
1806,task_1806,687,696,9,687,1293,0.006
1807,task_1807,676,690,14,676,990,0.008
1808,task_1808,1015,1027,12,1015,1075,0.008
1809,task_1809,107,119,12,107,833,0.013
1810,task_1810,920,933,13,918,1130,0.008
1811,task_1811,652,662,10,652,712,0.005
1812,task_1812,254,262,8,249,1362,0.005
1813,task_1813,655,664,9,651,1089,0.01
1814,task_1814,79,93,14,79,220,0.005
1815,task_1815,125,137,12,121,964,0.006
1816,task_1816,1174,1179,5,1172,1261,0.013
1817,task_1817,1072,1079,7,1072,1287,0.006
1818,task_1818,226,232,6,223,1246,0.013
1819,task_1819,529,539,10,529,1051,0.009
1820,task_1820,1117,1124,7,1108,1394,0.008
1821,task_1821,416,425,9,416,685,0.011
1822,task_1822,527,540,13,527,606,0.011
1823,task_1823,858,869,11,858,1075,0.012
1824,task_1824,478,492,14,478,1405,0.01
1825,task_1825,1390,1395,5,1390,1414,0.008
1826,task_1826,1302,1315,13,1291,1420,0.009
1827,task_1827,106,115,9,102,534,0.014
1828,task_1828,114,123,9,114,653,0.006
1829,task_1829,1277,1290,13,1276,1309,0.013
1830,task_1830,144,151,7,144,378,0.009
1831,task_1831,744,753,9,727,1329,0.012
1832,task_1832,1279,1290,11,1279,1360,0.011
1833,task_1833,655,662,7,655,856,0.008
1834,task_1834,966,980,14,966,1259,0.01
1835,task_1835,183,188,5,183,960,0.008
1836,task_1836,441,447,6,440,1166,0.01
1837,task_1837,1002,1008,6,1002,1188,0.005
1838,task_1838,571,580,9,569,1435,0.011
1839,task_1839,851,858,7,813,1349,0.011
1840,task_1840,845,858,13,842,1239,0.01
1841,task_1841,1145,1158,13,1145,1216,0.014
1842,task_1842,841,850,9,841,1003,0.014
1843,task_1843,45,54,9,45,738,0.005
1844,task_1844,1275,1289,14,1269,1407,0.01
1845,task_1845,759,772,13,745,1307,0.009
1846,task_1846,51,65,14,51,504,0.01
1847,task_1847,466,475,9,463,1006,0.013
1848,task_1848,211,222,11,210,1261,0.007
1849,task_1849,1328,1334,6,1328,1396,0.013
1850,task_1850,431,438,7,431,1239,0.005
1851,task_1851,869,874,5,869,1264,0.006
1852,task_1852,643,655,12,643,861,0.012
1853,task_1853,375,382,7,375,665,0.011
1854,task_1854,319,331,12,319,545,0.014
1855,task_1855,1186,1200,14,1184,1286,0.007
1856,task_1856,498,510,12,498,878,0.008
1857,task_1857,785,797,12,778,1257,0.012
1858,task_1858,863,872,9,835,1369,0.009
1859,task_1859,228,233,5,226,1416,0.013
1860,task_1860,881,888,7,879,1013,0.012
1861,task_1861,1202,1210,8,1201,1248,0.006
1862,task_1862,483,492,9,483,754,0.009
1863,task_1863,1228,1234,6,975,1422,0.011
1864,task_1864,705,713,8,705,904,0.012
1865,task_1865,1065,1073,8,1057,1339,0.014
1866,task_1866,455,466,11,455,1387,0.012
1867,task_1867,514,520,6,514,548,0.005
1868,task_1868,408,415,7,407,584,0.014
1869,task_1869,724,736,12,722,1356,0.005
1870,task_1870,259,273,14,258,413,0.01
1871,task_1871,992,1000,8,991,1077,0.008
1872,task_1872,519,528,9,519,611,0.014
1873,task_1873,1317,1330,13,1316,1356,0.014
1874,task_1874,794,800,6,794,956,0.007
1875,task_1875,56,67,11,56,429,0.011
1876,task_1876,946,960,14,943,1078,0.011
1877,task_1877,985,992,7,750,1410,0.012
1878,task_1878,498,508,10,498,779,0.009
1879,task_1879,797,805,8,793,1021,0.006
1880,task_1880,644,656,12,644,1408,0.009
1881,task_1881,374,380,6,374,647,0.011
1882,task_1882,406,419,13,344,1417,0.008
1883,task_1883,909,920,11,903,1367,0.012
1884,task_1884,975,985,10,964,1390,0.009
1885,task_1885,206,211,5,202,1168,0.012
1886,task_1886,837,845,8,834,1115,0.008
1887,task_1887,55,65,10,55,504,0.01
1888,task_1888,77,88,11,77,593,0.007
1889,task_1889,398,406,8,397,448,0.014
1890,task_1890,816,823,7,809,1322,0.01
1891,task_1891,799,813,14,799,871,0.01
1892,task_1892,971,979,8,971,1267,0.011
1893,task_1893,1073,1085,12,1060,1391,0.008
1894,task_1894,1033,1045,12,1033,1067,0.008
1895,task_1895,269,276,7,269,680,0.006
1896,task_1896,1343,1357,14,1343,1415,0.01
1897,task_1897,1119,1126,7,1060,1409,0.011
1898,task_1898,419,426,7,419,1036,0.007
1899,task_1899,1207,1213,6,1206,1406,0.011
1900,task_1900,430,441,11,429,602,0.01
1901,task_1901,1152,1158,6,1145,1304,0.012
1902,task_1902,940,949,9,940,1188,0.013
1903,task_1903,950,964,14,950,994,0.006
1904,task_1904,11,17,6,11,1391,0.007
1905,task_1905,168,181,13,168,870,0.008
1906,task_1906,567,575,8,566,1219,0.013
1907,task_1907,231,241,10,231,277,0.014
1908,task_1908,801,806,5,793,1060,0.005
1909,task_1909,78,84,6,78,748,0.011
1910,task_1910,1223,1233,10,1007,1424,0.013
1911,task_1911,350,361,11,349,511,0.009
1912,task_1912,554,567,13,550,1204,0.013
1913,task_1913,667,678,11,649,1321,0.007
1914,task_1914,1269,1279,10,1268,1370,0.01
1915,task_1915,323,329,6,322,606,0.013
1916,task_1916,564,576,12,558,1180,0.009
1917,task_1917,172,180,8,172,1043,0.009
1918,task_1918,433,445,12,429,1304,0.008
1919,task_1919,879,891,12,878,945,0.008
1920,task_1920,801,810,9,800,1123,0.011
1921,task_1921,134,148,14,134,884,0.014
1922,task_1922,1357,1362,5,1177,1436,0.009
1923,task_1923,151,156,5,150,525,0.01
1924,task_1924,117,131,14,116,1319,0.008
1925,task_1925,187,195,8,187,481,0.007
1926,task_1926,428,441,13,428,488,0.013
1927,task_1927,1327,1341,14,1327,1409,0.006
1928,task_1928,1208,1215,7,1208,1316,0.012
1929,task_1929,427,434,7,427,847,0.01
1930,task_1930,524,538,14,524,719,0.008
1931,task_1931,494,499,5,486,1227,0.01
1932,task_1932,1094,1100,6,1094,1323,0.007
1933,task_1933,135,143,8,135,935,0.012
1934,task_1934,98,107,9,89,1306,0.009
1935,task_1935,143,151,8,143,169,0.009
1936,task_1936,229,235,6,229,1412,0.012
1937,task_1937,792,803,11,788,1150,0.011
1938,task_1938,414,422,8,409,1114,0.012
1939,task_1939,892,899,7,883,1342,0.006
1940,task_1940,773,778,5,763,1279,0.007
1941,task_1941,677,685,8,677,909,0.007
1942,task_1942,500,509,9,500,1160,0.013
1943,task_1943,1106,1116,10,1106,1210,0.012
1944,task_1944,858,868,10,855,1275,0.009
1945,task_1945,1034,1040,6,1032,1269,0.011
1946,task_1946,1081,1092,11,1077,1142,0.013
1947,task_1947,721,726,5,720,1227,0.012
1948,task_1948,985,992,7,932,1411,0.006
1949,task_1949,1315,1321,6,1314,1403,0.01
1950,task_1950,312,319,7,308,1048,0.012
1951,task_1951,1117,1125,8,1057,1404,0.011
1952,task_1952,99,107,8,99,787,0.014
1953,task_1953,534,543,9,482,1428,0.011
1954,task_1954,122,127,5,122,757,0.009
1955,task_1955,1209,1221,12,1209,1265,0.008
1956,task_1956,705,711,6,705,1058,0.009
1957,task_1957,983,996,13,980,1405,0.008
1958,task_1958,329,341,12,328,1048,0.009
1959,task_1959,1158,1171,13,1148,1365,0.008
1960,task_1960,288,293,5,288,888,0.012
1961,task_1961,502,516,14,502,546,0.009
1962,task_1962,1237,1242,5,1236,1351,0.005
1963,task_1963,979,984,5,978,1330,0.014
1964,task_1964,249,260,11,247,927,0.01
1965,task_1965,265,279,14,265,333,0.006
1966,task_1966,1395,1406,11,1395,1427,0.014
1967,task_1967,106,118,12,106,209,0.01
1968,task_1968,164,178,14,164,851,0.011
1969,task_1969,1317,1326,9,1317,1361,0.013
1970,task_1970,737,749,12,737,1119,0.014
1971,task_1971,1121,1134,13,1121,1368,0.009
1972,task_1972,1115,1122,7,1115,1191,0.006
1973,task_1973,1355,1365,10,1355,1385,0.007
1974,task_1974,405,419,14,396,1415,0.011
1975,task_1975,246,253,7,246,270,0.008
1976,task_1976,404,414,10,402,450,0.008
1977,task_1977,1240,1248,8,1240,1375,0.011
1978,task_1978,968,976,8,953,1364,0.006
1979,task_1979,751,756,5,748,958,0.013
1980,task_1980,579,584,5,579,662,0.008
1981,task_1981,1120,1125,5,1098,1407,0.008
1982,task_1982,938,945,7,935,1057,0.01
1983,task_1983,1011,1020,9,1003,1378,0.011
1984,task_1984,1340,1350,10,1333,1402,0.01
1985,task_1985,462,473,11,462,551,0.012
1986,task_1986,1301,1308,7,1298,1397,0.012
1987,task_1987,1045,1053,8,1044,1279,0.01
1988,task_1988,31,42,11,31,848,0.013
1989,task_1989,298,304,6,298,347,0.011
1990,task_1990,339,353,14,339,985,0.012
1991,task_1991,1035,1041,6,1033,1303,0.013
1992,task_1992,887,898,11,883,1245,0.013
1993,task_1993,588,593,5,588,867,0.005
1994,task_1994,498,504,6,495,644,0.014
1995,task_1995,468,474,6,468,1061,0.005
1996,task_1996,1399,1406,7,1392,1437,0.005
1997,task_1997,687,692,5,677,1409,0.012
1998,task_1998,1245,1256,11,885,1435,0.013
1999,task_1999,1247,1261,14,1246,1280,0.005
