task No.,task_name,start_time,end_time,execution_time,earliest_time,latest_time,resource_load
0,task_0,867,878,11,867,1006,0.005
1,task_1,73,86,13,73,836,0.012
2,task_2,411,416,5,411,1096,0.005
3,task_3,206,212,6,204,1324,0.006
4,task_4,1117,1124,7,1110,1381,0.014
5,task_5,1386,1400,14,1386,1419,0.006
6,task_6,210,222,12,210,1400,0.01
7,task_7,768,773,5,768,893,0.009
8,task_8,539,546,7,539,880,0.011
9,task_9,1129,1137,8,1129,1294,0.007
10,task_10,883,893,10,881,1036,0.009
11,task_11,364,372,8,364,565,0.008
12,task_12,603,609,6,603,1348,0.01
13,task_13,393,398,5,391,420,0.014
14,task_14,144,154,10,144,582,0.013
15,task_15,374,387,13,374,428,0.005
16,task_16,332,342,10,332,750,0.007
17,task_17,896,908,12,896,1053,0.011
18,task_18,528,533,5,528,807,0.01
19,task_19,97,107,10,94,859,0.011
20,task_20,180,190,10,180,1253,0.013
21,task_21,632,638,6,632,1124,0.011
22,task_22,547,556,9,547,743,0.013
23,task_23,1234,1241,7,1234,1303,0.006
24,task_24,1138,1146,8,1046,1436,0.008
25,task_25,945,954,9,945,1046,0.008
26,task_26,36,50,14,36,1360,0.005
27,task_27,778,789,11,778,869,0.014
28,task_28,65,72,7,63,739,0.005
29,task_29,1165,1179,14,1160,1383,0.009
30,task_30,827,840,13,827,1052,0.011
31,task_31,1020,1033,13,1020,1203,0.01
32,task_32,554,563,9,547,1334,0.007
33,task_33,898,904,6,898,1169,0.006
34,task_34,598,606,8,598,1182,0.013
35,task_35,704,718,14,704,993,0.005
36,task_36,407,419,12,407,1318,0.009
37,task_37,465,474,9,465,598,0.006
38,task_38,1112,1122,10,1111,1383,0.009
39,task_39,914,921,7,914,961,0.006
40,task_40,882,890,8,882,929,0.006
41,task_41,83,92,9,82,334,0.005
42,task_42,939,947,8,930,1362,0.013
43,task_43,74,84,10,74,1112,0.01
44,task_44,890,898,8,884,1332,0.014
45,task_45,597,611,14,597,1379,0.014
46,task_46,229,235,6,229,1382,0.005
47,task_47,142,147,5,142,330,0.01
48,task_48,938,946,8,937,1239,0.008
49,task_49,505,513,8,496,1285,0.012
50,task_50,900,907,7,899,1318,0.012
51,task_51,192,200,8,192,590,0.012
52,task_52,1026,1037,11,1025,1297,0.012
53,task_53,291,305,14,291,578,0.014
54,task_54,415,426,11,415,450,0.009
55,task_55,725,734,9,725,856,0.006
56,task_56,380,390,10,380,467,0.006
57,task_57,1182,1196,14,1182,1342,0.008
58,task_58,1086,1095,9,1085,1284,0.014
59,task_59,1162,1173,11,1161,1341,0.012
60,task_60,827,838,11,827,928,0.012
61,task_61,333,339,6,333,576,0.014
62,task_62,19,27,8,19,472,0.01
63,task_63,114,119,5,113,538,0.007
64,task_64,740,753,13,738,946,0.006
65,task_65,1192,1203,11,1192,1271,0.012
66,task_66,694,700,6,694,734,0.007
67,task_67,276,290,14,276,689,0.014
68,task_68,1265,1278,13,1265,1326,0.006
69,task_69,5,11,6,5,1133,0.013
70,task_70,1261,1274,13,1261,1310,0.008
71,task_71,1323,1337,14,1322,1433,0.005
72,task_72,492,505,13,491,1036,0.012
73,task_73,773,782,9,771,1140,0.012
74,task_74,927,932,5,927,1211,0.011
75,task_75,339,345,6,339,1096,0.006
76,task_76,932,937,5,932,1275,0.008
77,task_77,280,290,10,280,713,0.007
78,task_78,320,331,11,311,1313,0.007
79,task_79,664,676,12,662,923,0.01
80,task_80,317,328,11,314,1249,0.01
81,task_81,1378,1390,12,1375,1434,0.01
82,task_82,804,813,9,804,890,0.014
83,task_83,122,127,5,122,849,0.006
84,task_84,320,334,14,320,532,0.009
85,task_85,389,397,8,389,1120,0.014
86,task_86,1118,1123,5,1010,1412,0.011
87,task_87,442,451,9,442,944,0.008
88,task_88,1401,1407,6,1395,1436,0.01
89,task_89,650,664,14,648,1133,0.007
90,task_90,876,883,7,876,1119,0.007
91,task_91,792,804,12,788,1125,0.014
92,task_92,1314,1324,10,1313,1429,0.006
93,task_93,474,480,6,474,1412,0.005
94,task_94,416,430,14,415,1256,0.01
95,task_95,999,1012,13,998,1318,0.005
96,task_96,38,44,6,38,476,0.009
97,task_97,1133,1139,6,1133,1165,0.011
98,task_98,1012,1022,10,1012,1146,0.011
99,task_99,105,116,11,102,797,0.008
100,task_100,1093,1104,11,1093,1332,0.012
101,task_101,685,693,8,658,1422,0.006
102,task_102,1374,1386,12,1374,1417,0.011
103,task_103,16,24,8,16,125,0.011
104,task_104,840,854,14,839,1260,0.005
105,task_105,1080,1090,10,1070,1411,0.011
106,task_106,1072,1080,8,1072,1295,0.005
107,task_107,907,913,6,907,1060,0.007
108,task_108,1140,1146,6,1140,1271,0.01
109,task_109,182,192,10,182,212,0.006
110,task_110,380,387,7,380,435,0.007
111,task_111,510,517,7,510,884,0.013
112,task_112,973,985,12,972,1297,0.008
113,task_113,1007,1020,13,1007,1322,0.005
114,task_114,817,830,13,817,1207,0.011
115,task_115,794,803,9,794,1150,0.006
116,task_116,1247,1259,12,1247,1369,0.007
117,task_117,862,869,7,829,1409,0.007
118,task_118,1248,1256,8,1248,1401,0.007
119,task_119,440,453,13,440,591,0.014
120,task_120,370,378,8,363,1235,0.01
121,task_121,64,72,8,64,478,0.014
122,task_122,153,165,12,152,242,0.006
123,task_123,1221,1231,10,1221,1261,0.011
124,task_124,1026,1037,11,1025,1298,0.005
125,task_125,55,63,8,55,1208,0.01
126,task_126,1064,1075,11,1063,1212,0.012
127,task_127,967,976,9,967,1048,0.014
128,task_128,1297,1304,7,1297,1377,0.006
129,task_129,766,780,14,764,1045,0.011
130,task_130,1179,1192,13,1179,1318,0.007
131,task_131,1309,1323,14,1309,1335,0.012
132,task_132,895,901,6,895,964,0.013
133,task_133,312,326,14,310,574,0.012
134,task_134,272,279,7,272,1258,0.006
135,task_135,248,258,10,248,293,0.006
136,task_136,251,260,9,251,909,0.005
137,task_137,818,829,11,818,1315,0.005
138,task_138,835,842,7,835,928,0.01
139,task_139,1085,1096,11,1085,1155,0.01
140,task_140,276,287,11,276,1342,0.011
141,task_141,351,356,5,350,636,0.006
142,task_142,613,621,8,613,1242,0.007
143,task_143,1175,1189,14,1174,1412,0.014
144,task_144,921,927,6,911,1404,0.007
145,task_145,1265,1272,7,1265,1422,0.013
146,task_146,832,841,9,830,1112,0.013
147,task_147,1273,1281,8,1273,1301,0.013
148,task_148,1132,1139,7,1131,1369,0.014
149,task_149,684,697,13,682,1185,0.005
150,task_150,532,543,11,532,1010,0.013
151,task_151,716,726,10,716,1056,0.006
152,task_152,143,150,7,143,1200,0.008
153,task_153,451,458,7,451,1072,0.008
154,task_154,1188,1198,10,1188,1340,0.006
155,task_155,366,377,11,364,882,0.013
156,task_156,608,622,14,608,1416,0.011
157,task_157,725,730,5,725,1381,0.007
158,task_158,744,758,14,736,1367,0.014
159,task_159,416,427,11,415,695,0.013
160,task_160,52,64,12,52,559,0.011
161,task_161,1053,1064,11,1053,1231,0.011
162,task_162,486,494,8,485,839,0.011
163,task_163,647,658,11,647,767,0.014
164,task_164,376,389,13,375,694,0.011
165,task_165,237,243,6,237,662,0.009
166,task_166,811,820,9,800,1329,0.005
167,task_167,654,666,12,651,1036,0.011
168,task_168,1003,1008,5,1003,1208,0.008
169,task_169,769,776,7,765,1352,0.008
170,task_170,1134,1142,8,1133,1169,0.005
171,task_171,155,164,9,155,553,0.011
172,task_172,516,529,13,512,1131,0.012
173,task_173,1347,1359,12,1347,1386,0.01
174,task_174,238,250,12,238,466,0.009
175,task_175,1067,1080,13,1067,1245,0.014
176,task_176,418,430,12,418,896,0.009
177,task_177,170,182,12,170,1220,0.011
178,task_178,1210,1223,13,1210,1398,0.008
179,task_179,1196,1210,14,1193,1363,0.01
180,task_180,1301,1313,12,1299,1439,0.012
181,task_181,885,897,12,885,949,0.007
182,task_182,1402,1407,5,1380,1435,0.008
183,task_183,493,499,6,493,540,0.01
184,task_184,163,175,12,163,1347,0.012
185,task_185,109,114,5,109,679,0.006
186,task_186,1109,1120,11,1108,1145,0.012
187,task_187,875,883,8,873,1376,0.014
188,task_188,36,46,10,36,928,0.007
189,task_189,1219,1229,10,1219,1287,0.008
190,task_190,560,571,11,560,771,0.011
191,task_191,326,335,9,325,751,0.013
192,task_192,48,56,8,48,1205,0.011
193,task_193,490,503,13,490,1205,0.007
194,task_194,878,884,6,877,1379,0.01
195,task_195,1195,1200,5,1194,1311,0.01
196,task_196,522,534,12,518,1366,0.007
197,task_197,1119,1132,13,1028,1420,0.013
198,task_198,724,733,9,724,1182,0.005
199,task_199,1253,1261,8,1253,1397,0.006
200,task_200,434,444,10,434,472,0.009
201,task_201,466,475,9,465,1218,0.014
202,task_202,1319,1333,14,1311,1436,0.005
203,task_203,193,207,14,193,1438,0.012
204,task_204,637,651,14,637,859,0.006
205,task_205,755,763,8,754,912,0.01
206,task_206,679,691,12,679,1307,0.013
207,task_207,715,723,8,715,1127,0.009
208,task_208,309,320,11,309,522,0.012
209,task_209,1389,1394,5,1389,1416,0.013
210,task_210,983,990,7,983,1000,0.014
211,task_211,1388,1395,7,1388,1420,0.005
212,task_212,632,644,12,632,1345,0.009
213,task_213,706,719,13,706,1070,0.011
214,task_214,1393,1406,13,1392,1423,0.006
215,task_215,1051,1057,6,1037,1325,0.009
216,task_216,691,700,9,650,1433,0.008
217,task_217,919,933,14,918,1240,0.014
218,task_218,354,368,14,351,1117,0.005
219,task_219,1041,1055,14,1041,1141,0.009
220,task_220,776,785,9,776,1027,0.009
221,task_221,1202,1212,10,1202,1226,0.007
222,task_222,1146,1151,5,1146,1183,0.01
223,task_223,555,568,13,555,1286,0.011
224,task_224,671,681,10,665,1328,0.013
225,task_225,1248,1260,12,1248,1321,0.012
226,task_226,941,952,11,941,1309,0.013
227,task_227,558,564,6,558,665,0.011
228,task_228,930,941,11,930,1083,0.014
229,task_229,1006,1019,13,1006,1254,0.006
230,task_230,1351,1362,11,1351,1429,0.012
231,task_231,1258,1265,7,1258,1374,0.009
232,task_232,926,939,13,926,1062,0.006
233,task_233,1088,1093,5,1084,1305,0.013
234,task_234,1043,1056,13,1043,1267,0.006
235,task_235,69,78,9,69,494,0.006
236,task_236,305,316,11,305,647,0.006
237,task_237,961,974,13,961,1066,0.006
238,task_238,1350,1355,5,1350,1424,0.005
239,task_239,884,898,14,880,1234,0.009
240,task_240,656,669,13,655,1184,0.006
241,task_241,1258,1263,5,1258,1369,0.006
242,task_242,223,229,6,223,401,0.014
243,task_243,595,600,5,595,737,0.006
244,task_244,526,535,9,526,1329,0.011
245,task_245,625,630,5,625,1322,0.008
246,task_246,590,595,5,590,1310,0.012
247,task_247,706,718,12,706,776,0.006
248,task_248,13,25,12,13,347,0.012
249,task_249,927,934,7,926,1136,0.01
250,task_250,1309,1316,7,1309,1343,0.009
251,task_251,24,33,9,24,1400,0.007
252,task_252,962,969,7,841,1426,0.013
253,task_253,22,33,11,22,1109,0.006
254,task_254,693,706,13,693,757,0.01
255,task_255,93,106,13,93,700,0.008
256,task_256,1135,1145,10,1133,1359,0.012
257,task_257,455,469,14,455,981,0.008
258,task_258,757,769,12,750,1263,0.012
259,task_259,1361,1367,6,1361,1428,0.014
260,task_260,42,51,9,42,568,0.009
261,task_261,634,644,10,634,1424,0.013
262,task_262,405,417,12,405,934,0.006
263,task_263,38,43,5,38,607,0.01
264,task_264,883,890,7,881,1111,0.005
265,task_265,1168,1175,7,1145,1411,0.006
266,task_266,743,749,6,743,815,0.014
267,task_267,1025,1035,10,1025,1100,0.006
268,task_268,646,659,13,646,1360,0.01
269,task_269,691,699,8,691,774,0.006
270,task_270,1011,1016,5,1009,1290,0.005
271,task_271,674,680,6,672,945,0.009
272,task_272,306,316,10,298,1146,0.007
273,task_273,592,602,10,592,1285,0.008
274,task_274,1397,1409,12,1395,1433,0.013
275,task_275,1318,1329,11,1318,1432,0.012
276,task_276,1361,1366,5,1361,1411,0.005
277,task_277,1268,1278,10,1268,1390,0.008
278,task_278,674,684,10,674,851,0.009
279,task_279,583,590,7,583,1085,0.009
280,task_280,361,375,14,358,1309,0.013
281,task_281,990,1002,12,990,1113,0.008
282,task_282,58,69,11,58,905,0.012
283,task_283,894,902,8,891,1377,0.013
284,task_284,870,881,11,870,902,0.009
285,task_285,1100,1105,5,1099,1215,0.01
286,task_286,1135,1149,14,1007,1431,0.009
287,task_287,1250,1261,11,1250,1391,0.008
288,task_288,939,947,8,931,1349,0.006
289,task_289,457,466,9,457,1269,0.009
290,task_290,195,208,13,195,557,0.006
291,task_291,638,646,8,638,772,0.014
292,task_292,579,590,11,579,1054,0.006
293,task_293,95,105,10,95,660,0.01
294,task_294,972,982,10,972,1262,0.014
295,task_295,817,829,12,817,1374,0.006
296,task_296,358,371,13,358,540,0.005
297,task_297,641,655,14,641,681,0.012
298,task_298,814,826,12,790,1387,0.009
299,task_299,1344,1351,7,1344,1406,0.008
300,task_300,271,285,14,271,1199,0.013
301,task_301,996,1007,11,996,1313,0.007
302,task_302,773,781,8,773,925,0.01
303,task_303,719,728,9,719,1040,0.008
304,task_304,577,588,11,577,696,0.009
305,task_305,648,662,14,648,1084,0.01
306,task_306,65,72,7,60,731,0.007
307,task_307,1300,1309,9,1279,1425,0.011
308,task_308,1030,1038,8,1030,1172,0.011
309,task_309,658,670,12,658,1023,0.008
310,task_310,817,827,10,817,1235,0.014
311,task_311,84,95,11,81,794,0.009
312,task_312,371,379,8,371,398,0.013
313,task_313,384,393,9,384,464,0.009
314,task_314,453,458,5,453,1296,0.012
315,task_315,1293,1303,10,1292,1373,0.012
316,task_316,847,857,10,843,1244,0.013
317,task_317,1334,1342,8,1334,1381,0.012
318,task_318,1131,1141,10,1131,1210,0.012
319,task_319,561,568,7,561,653,0.006
320,task_320,817,826,9,798,1389,0.01
321,task_321,1017,1029,12,1017,1116,0.011
322,task_322,779,789,10,779,878,0.006
323,task_323,327,337,10,327,1270,0.005
324,task_324,388,401,13,388,505,0.006
325,task_325,439,448,9,439,1261,0.006
326,task_326,570,581,11,570,665,0.011
327,task_327,647,659,12,647,1313,0.012
328,task_328,238,252,14,238,339,0.011
329,task_329,188,196,8,188,1193,0.006
330,task_330,833,846,13,822,1189,0.007
331,task_331,340,354,14,340,419,0.012
332,task_332,950,956,6,950,968,0.013
333,task_333,1298,1306,8,1298,1357,0.012
334,task_334,1171,1176,5,1171,1389,0.013
335,task_335,1353,1362,9,1353,1383,0.011
336,task_336,903,913,10,902,1067,0.013
337,task_337,907,921,14,892,1405,0.012
338,task_338,267,275,8,267,322,0.012
339,task_339,736,748,12,736,1237,0.008
340,task_340,387,400,13,386,795,0.014
341,task_341,66,75,9,66,468,0.007
342,task_342,1060,1067,7,1058,1291,0.009
343,task_343,759,765,6,759,1054,0.006
344,task_344,1387,1400,13,1384,1430,0.01
345,task_345,429,436,7,429,1307,0.006
346,task_346,901,913,12,901,1247,0.014
347,task_347,40,48,8,40,962,0.011
348,task_348,1042,1051,9,1042,1100,0.007
349,task_349,240,251,11,240,842,0.007
350,task_350,80,87,7,80,1401,0.011
351,task_351,671,677,6,671,1373,0.011
352,task_352,1296,1305,9,1295,1383,0.01
353,task_353,1229,1235,6,1229,1283,0.013
354,task_354,1194,1201,7,1194,1237,0.013
355,task_355,686,692,6,686,1386,0.01
356,task_356,87,99,12,85,749,0.009
357,task_357,333,342,9,333,752,0.006
358,task_358,1297,1306,9,1291,1414,0.011
359,task_359,1082,1096,14,1082,1141,0.013
360,task_360,1192,1200,8,1192,1353,0.008
361,task_361,931,936,5,930,1246,0.014
362,task_362,1256,1267,11,1256,1295,0.013
363,task_363,1231,1239,8,1231,1436,0.006
364,task_364,107,121,14,107,336,0.005
365,task_365,1221,1229,8,1221,1340,0.008
366,task_366,706,716,10,702,1357,0.014
367,task_367,361,369,8,361,731,0.009
368,task_368,918,924,6,918,962,0.009
369,task_369,471,478,7,471,611,0.012
370,task_370,193,206,13,193,343,0.009
371,task_371,766,776,10,764,1178,0.01
372,task_372,794,801,7,794,816,0.013
373,task_373,1055,1060,5,1040,1331,0.008
374,task_374,745,759,14,745,982,0.007
375,task_375,1014,1023,9,1014,1161,0.005
376,task_376,791,799,8,790,959,0.007
377,task_377,57,64,7,57,670,0.005
378,task_378,1264,1270,6,1264,1288,0.006
379,task_379,591,598,7,591,1434,0.009
380,task_380,161,169,8,161,1388,0.005
381,task_381,86,92,6,85,366,0.008
382,task_382,1281,1287,6,1281,1310,0.011
383,task_383,624,636,12,624,1421,0.014
384,task_384,37,46,9,37,1387,0.01
385,task_385,551,560,9,551,914,0.013
386,task_386,862,876,14,862,1290,0.006
387,task_387,69,77,8,61,1423,0.007
388,task_388,209,222,13,209,1259,0.008
389,task_389,36,44,8,36,107,0.01
390,task_390,528,542,14,528,697,0.005
391,task_391,963,971,8,963,1068,0.01
392,task_392,785,798,13,785,1043,0.008
393,task_393,55,64,9,55,1430,0.005
394,task_394,1217,1228,11,1217,1375,0.006
395,task_395,436,448,12,436,494,0.011
396,task_396,1177,1188,11,1177,1243,0.011
397,task_397,1061,1067,6,1061,1127,0.013
398,task_398,983,993,10,930,1438,0.009
399,task_399,756,769,13,746,1256,0.013
400,task_400,1143,1154,11,1142,1170,0.011
401,task_401,746,757,11,746,811,0.009
402,task_402,1165,1172,7,1154,1407,0.014
403,task_403,1189,1199,10,1189,1231,0.009
404,task_404,1043,1051,8,1042,1182,0.014
405,task_405,549,562,13,547,1064,0.014
406,task_406,1278,1286,8,1277,1399,0.008
407,task_407,897,907,10,897,962,0.006
408,task_408,1254,1266,12,1254,1338,0.005
409,task_409,972,977,5,969,1274,0.012
410,task_410,576,586,10,576,1092,0.007
411,task_411,1080,1085,5,1080,1379,0.005
412,task_412,1263,1269,6,1263,1393,0.005
413,task_413,370,376,6,369,937,0.013
414,task_414,808,815,7,808,1052,0.008
415,task_415,699,707,8,699,833,0.006
416,task_416,252,259,7,252,1202,0.012
417,task_417,612,622,10,612,768,0.01
418,task_418,676,686,10,676,1247,0.007
419,task_419,1167,1177,10,1166,1348,0.011
420,task_420,873,879,6,873,1236,0.005
421,task_421,1323,1336,13,1323,1385,0.008
422,task_422,256,266,10,256,333,0.01
423,task_423,362,375,13,362,508,0.013
424,task_424,1335,1346,11,1335,1416,0.005
425,task_425,1283,1296,13,1283,1348,0.009
426,task_426,42,55,13,42,163,0.01
427,task_427,1351,1364,13,1351,1412,0.008
428,task_428,1356,1366,10,1356,1388,0.009
429,task_429,928,936,8,925,1249,0.011
430,task_430,655,663,8,655,1046,0.005
431,task_431,250,258,8,250,501,0.006
432,task_432,1060,1073,13,1060,1245,0.011
433,task_433,1100,1113,13,1099,1164,0.01
434,task_434,667,681,14,660,1307,0.008
435,task_435,328,333,5,328,729,0.006
436,task_436,716,728,12,710,1211,0.009
437,task_437,1336,1343,7,1336,1356,0.008
438,task_438,181,186,5,181,1270,0.008
439,task_439,229,243,14,229,589,0.005
440,task_440,683,696,13,683,905,0.008
441,task_441,980,992,12,967,1429,0.011
442,task_442,1330,1338,8,1330,1356,0.006
443,task_443,940,948,8,940,1042,0.01
444,task_444,826,833,7,826,1067,0.013
445,task_445,1213,1218,5,1213,1348,0.007
446,task_446,48,54,6,48,1232,0.005
447,task_447,91,97,6,90,935,0.011
448,task_448,526,533,7,524,1331,0.007
449,task_449,1075,1080,5,1075,1398,0.009
450,task_450,476,486,10,476,1039,0.008
451,task_451,1024,1030,6,1024,1163,0.009
452,task_452,1080,1090,10,1077,1383,0.008
453,task_453,305,319,14,302,1005,0.009
454,task_454,304,310,6,304,688,0.007
455,task_455,283,289,6,283,1172,0.012
456,task_456,1354,1359,5,1354,1416,0.007
457,task_457,363,374,11,363,576,0.005
458,task_458,757,768,11,757,812,0.006
459,task_459,822,828,6,821,922,0.01
460,task_460,592,602,10,592,1433,0.014
461,task_461,328,339,11,328,671,0.009
462,task_462,330,335,5,330,1023,0.011
463,task_463,419,433,14,419,1431,0.014
464,task_464,1,9,8,1,1088,0.009
465,task_465,260,272,12,260,483,0.008
466,task_466,623,633,10,623,1354,0.009
467,task_467,1337,1347,10,1337,1363,0.009
468,task_468,985,992,7,972,1439,0.014
469,task_469,249,255,6,249,1261,0.005
470,task_470,259,268,9,259,999,0.012
471,task_471,285,294,9,285,986,0.01
472,task_472,1034,1039,5,1033,1148,0.006
473,task_473,364,374,10,364,472,0.006
474,task_474,124,137,13,123,688,0.012
475,task_475,1212,1219,7,1212,1273,0.012
476,task_476,1045,1055,10,1040,1301,0.01
477,task_477,397,407,10,397,664,0.009
478,task_478,94,108,14,94,161,0.013
479,task_479,1246,1254,8,1246,1265,0.014
480,task_480,300,305,5,300,746,0.01
481,task_481,379,390,11,379,982,0.008
482,task_482,172,181,9,172,1011,0.008
483,task_483,819,827,8,818,1376,0.014
484,task_484,1327,1341,14,1327,1407,0.011
485,task_485,1377,1389,12,1376,1423,0.01
486,task_486,438,445,7,438,545,0.007
487,task_487,1140,1152,12,1140,1250,0.013
488,task_488,485,498,13,485,842,0.01
489,task_489,740,752,12,738,867,0.012
490,task_490,754,759,5,754,890,0.011
491,task_491,1144,1152,8,1144,1282,0.014
492,task_492,433,439,6,433,512,0.008
493,task_493,500,512,12,500,722,0.005
494,task_494,368,379,11,362,1144,0.009
495,task_495,1164,1175,11,1164,1321,0.014
496,task_496,961,969,8,961,1133,0.006
497,task_497,100,114,14,100,871,0.006
498,task_498,86,93,7,85,662,0.006
499,task_499,717,725,8,709,1327,0.01
500,task_500,732,744,12,732,1097,0.011
501,task_501,763,773,10,763,938,0.01
502,task_502,808,817,9,808,1146,0.014
503,task_503,620,626,6,620,912,0.009
504,task_504,215,223,8,215,708,0.008
505,task_505,1195,1204,9,1193,1294,0.01
506,task_506,907,918,11,886,1425,0.013
507,task_507,158,163,5,158,1311,0.013
508,task_508,1350,1356,6,1350,1423,0.012
509,task_509,34,46,12,34,986,0.011
510,task_510,1229,1237,8,1229,1341,0.01
511,task_511,705,719,14,705,1294,0.013
512,task_512,380,394,14,348,1383,0.009
513,task_513,1405,1410,5,1380,1438,0.011
514,task_514,490,504,14,485,1261,0.014
515,task_515,523,533,10,507,1429,0.006
516,task_516,456,464,8,456,1389,0.005
517,task_517,1386,1399,13,1386,1417,0.006
518,task_518,370,380,10,370,767,0.009
519,task_519,518,526,8,518,704,0.008
520,task_520,1018,1025,7,1017,1216,0.014
521,task_521,730,737,7,730,1081,0.012
522,task_522,1227,1233,6,1227,1267,0.014
523,task_523,1265,1274,9,1265,1328,0.006
524,task_524,1023,1037,14,1023,1182,0.01
525,task_525,701,706,5,696,1255,0.013
526,task_526,410,420,10,408,1177,0.008
527,task_527,913,923,10,913,964,0.006
528,task_528,238,245,7,238,1334,0.007
529,task_529,552,565,13,552,957,0.005
530,task_530,650,660,10,649,1103,0.011
531,task_531,617,630,13,617,984,0.014
532,task_532,1313,1320,7,1313,1355,0.013
533,task_533,196,205,9,196,236,0.008
534,task_534,1327,1340,13,1327,1413,0.013
535,task_535,137,147,10,137,1226,0.014
536,task_536,956,970,14,956,1062,0.006
537,task_537,1191,1196,5,1191,1342,0.013
538,task_538,942,954,12,942,1331,0.012
539,task_539,130,143,13,130,1240,0.014
540,task_540,1403,1408,5,1397,1435,0.008
541,task_541,1320,1329,9,1320,1367,0.007
542,task_542,990,1000,10,990,1424,0.012
543,task_543,323,336,13,323,1108,0.011
544,task_544,1306,1319,13,1304,1387,0.008
545,task_545,949,956,7,949,1120,0.011
546,task_546,1038,1045,7,1038,1204,0.005
547,task_547,18,31,13,18,78,0.009
548,task_548,209,218,9,208,1361,0.014
549,task_549,72,78,6,71,655,0.012
550,task_550,503,512,9,503,1067,0.01
551,task_551,407,418,11,401,1425,0.005
552,task_552,627,639,12,627,1197,0.014
553,task_553,198,207,9,197,1221,0.013
554,task_554,922,931,9,922,1069,0.008
555,task_555,557,568,11,556,743,0.011
556,task_556,88,95,7,88,823,0.012
557,task_557,1365,1377,12,1365,1400,0.007
558,task_558,711,723,12,711,769,0.01
559,task_559,728,736,8,728,1413,0.005
560,task_560,397,406,9,396,1074,0.007
561,task_561,988,1001,13,988,1398,0.01
562,task_562,1053,1059,6,1053,1077,0.01
563,task_563,1404,1411,7,1378,1439,0.007
564,task_564,1065,1072,7,1031,1373,0.012
565,task_565,193,206,13,192,1334,0.008
566,task_566,77,85,8,77,966,0.006
567,task_567,1151,1157,6,1147,1405,0.009
568,task_568,198,204,6,197,1271,0.013
569,task_569,1041,1055,14,1041,1177,0.005
570,task_570,799,812,13,798,1057,0.007
571,task_571,558,567,9,558,647,0.005
572,task_572,470,476,6,470,790,0.008
573,task_573,1231,1238,7,1231,1394,0.006
574,task_574,1398,1408,10,1388,1436,0.013
575,task_575,610,622,12,610,978,0.014
576,task_576,639,644,5,639,702,0.014
577,task_577,701,706,5,701,796,0.005
578,task_578,1157,1167,10,1155,1268,0.014
579,task_579,260,271,11,260,1421,0.009
580,task_580,1070,1084,14,1051,1407,0.009
581,task_581,773,778,5,772,1195,0.005
582,task_582,868,881,13,867,1214,0.012
583,task_583,1260,1266,6,1259,1356,0.01
584,task_584,826,838,12,826,965,0.01
585,task_585,275,287,12,275,641,0.009
586,task_586,841,851,10,841,1303,0.005
587,task_587,438,449,11,438,783,0.013
588,task_588,1291,1298,7,1291,1347,0.007
589,task_589,1352,1358,6,1352,1416,0.007
590,task_590,63,73,10,62,598,0.012
591,task_591,538,544,6,538,1391,0.006
592,task_592,484,490,6,484,854,0.014
593,task_593,703,716,13,702,828,0.005
594,task_594,872,878,6,871,1199,0.01
595,task_595,992,999,7,991,1174,0.01
596,task_596,982,988,6,908,1430,0.007
597,task_597,333,345,12,333,719,0.013
598,task_598,1105,1116,11,1101,1387,0.014
599,task_599,101,107,6,101,1409,0.011
600,task_600,642,655,13,642,1284,0.005
601,task_601,499,510,11,494,1126,0.009
602,task_602,292,301,9,292,752,0.014
603,task_603,1091,1103,12,1091,1201,0.012
604,task_604,644,651,7,643,886,0.012
605,task_605,874,883,9,874,1374,0.012
606,task_606,1093,1101,8,1093,1131,0.011
607,task_607,1098,1112,14,1098,1278,0.014
608,task_608,449,456,7,449,816,0.007
609,task_609,801,811,10,792,1222,0.012
610,task_610,2,14,12,2,65,0.005
611,task_611,465,472,7,465,885,0.012
612,task_612,935,940,5,935,1035,0.008
613,task_613,379,388,9,379,758,0.013
614,task_614,655,665,10,652,1142,0.011
615,task_615,813,826,13,813,1340,0.013
616,task_616,1001,1006,5,1000,1250,0.014
617,task_617,210,219,9,210,1058,0.009
618,task_618,189,203,14,189,1200,0.014
619,task_619,1087,1100,13,1084,1294,0.014
620,task_620,395,405,10,395,1033,0.014
621,task_621,356,362,6,355,949,0.006
622,task_622,774,785,11,774,834,0.013
623,task_623,1272,1284,12,1270,1434,0.012
624,task_624,596,602,6,596,996,0.011
625,task_625,972,983,11,972,1052,0.008
626,task_626,1237,1251,14,1237,1328,0.011
627,task_627,883,895,12,882,1161,0.014
628,task_628,732,744,12,732,1387,0.01
629,task_629,377,388,11,362,1342,0.01
630,task_630,1132,1137,5,1132,1395,0.012
631,task_631,320,328,8,302,1309,0.014
632,task_632,32,45,13,32,1281,0.007
633,task_633,477,489,12,477,1024,0.012
634,task_634,25,30,5,25,776,0.007
635,task_635,339,351,12,339,502,0.01
636,task_636,845,854,9,844,1220,0.008
637,task_637,1159,1170,11,1159,1352,0.012
638,task_638,1201,1208,7,1201,1307,0.005
639,task_639,233,239,6,233,901,0.012
640,task_640,809,816,7,808,1262,0.007
641,task_641,1080,1092,12,1078,1280,0.013
642,task_642,1103,1112,9,1099,1357,0.011
643,task_643,833,841,8,828,1176,0.008
644,task_644,258,266,8,258,321,0.01
645,task_645,1109,1114,5,1108,1155,0.006
646,task_646,1290,1302,12,1290,1340,0.007
647,task_647,939,946,7,935,1340,0.006
648,task_648,520,525,5,520,568,0.006
649,task_649,214,225,11,214,397,0.012
650,task_650,128,134,6,128,175,0.008
651,task_651,922,935,13,810,1429,0.012
652,task_652,806,814,8,801,1308,0.006
653,task_653,960,974,14,959,1309,0.007
654,task_654,368,377,9,368,519,0.005
655,task_655,759,772,13,759,1018,0.013
656,task_656,277,287,10,277,1025,0.014
657,task_657,151,158,7,151,829,0.01
658,task_658,372,380,8,372,724,0.013
659,task_659,1057,1064,7,1057,1100,0.005
660,task_660,413,423,10,413,1233,0.005
661,task_661,1249,1254,5,1249,1297,0.012
662,task_662,21,27,6,21,1214,0.01
663,task_663,1101,1111,10,1100,1287,0.014
664,task_664,583,588,5,583,1002,0.014
665,task_665,820,829,9,820,1126,0.006
666,task_666,952,962,10,951,1302,0.009
667,task_667,1233,1240,7,1233,1334,0.007
668,task_668,366,371,5,365,900,0.005
669,task_669,143,148,5,143,819,0.014
670,task_670,5,10,5,5,143,0.01
671,task_671,479,490,11,479,1176,0.013
672,task_672,820,834,14,820,1190,0.005
673,task_673,965,975,10,965,1001,0.008
674,task_674,920,931,11,913,1376,0.014
675,task_675,1259,1272,13,1259,1340,0.013
676,task_676,1219,1231,12,1219,1319,0.005
677,task_677,1143,1153,10,1141,1400,0.005
678,task_678,1141,1150,9,1141,1233,0.01
679,task_679,411,419,8,411,1061,0.01
680,task_680,676,684,8,674,1161,0.01
681,task_681,423,437,14,423,940,0.005
682,task_682,1264,1275,11,1264,1421,0.009
683,task_683,733,746,13,733,1172,0.008
684,task_684,954,968,14,954,1197,0.009
685,task_685,1334,1341,7,1334,1383,0.01
686,task_686,697,710,13,697,1002,0.01
687,task_687,1215,1223,8,1215,1328,0.014
688,task_688,70,75,5,70,832,0.006
689,task_689,670,678,8,670,1300,0.012
690,task_690,387,395,8,387,423,0.006
691,task_691,507,521,14,507,602,0.014
692,task_692,1386,1397,11,1385,1423,0.01
693,task_693,1006,1014,8,996,1373,0.012
694,task_694,106,116,10,104,959,0.007
695,task_695,746,757,11,746,959,0.009
696,task_696,157,167,10,157,857,0.006
697,task_697,53,63,10,53,244,0.006
698,task_698,121,126,5,121,854,0.014
699,task_699,1210,1220,10,1210,1417,0.013
700,task_700,526,533,7,524,1387,0.008
701,task_701,1212,1221,9,1212,1380,0.01
702,task_702,1300,1314,14,1300,1386,0.007
703,task_703,461,474,13,461,1038,0.012
704,task_704,547,561,14,547,1006,0.013
705,task_705,1134,1144,10,1134,1227,0.008
706,task_706,156,167,11,156,458,0.008
707,task_707,345,351,6,345,1283,0.005
708,task_708,983,991,8,792,1434,0.012
709,task_709,947,956,9,945,1341,0.013
710,task_710,1391,1404,13,1390,1428,0.008
711,task_711,1182,1195,13,1182,1314,0.005
712,task_712,1067,1073,6,1067,1381,0.007
713,task_713,315,323,8,315,866,0.007
714,task_714,161,168,7,161,721,0.011
715,task_715,694,704,10,694,1323,0.011
716,task_716,854,859,5,854,1157,0.008
717,task_717,162,170,8,162,1077,0.013
718,task_718,288,298,10,288,1306,0.007
719,task_719,64,77,13,64,517,0.011
720,task_720,452,457,5,452,1200,0.012
721,task_721,1118,1129,11,1118,1253,0.008
722,task_722,962,972,10,844,1429,0.012
723,task_723,1081,1093,12,1005,1414,0.006
724,task_724,1380,1386,6,1375,1431,0.008
725,task_725,996,1010,14,996,1130,0.013
726,task_726,656,664,8,648,1157,0.014
727,task_727,78,86,8,78,1360,0.013
728,task_728,1090,1100,10,1090,1389,0.006
729,task_729,459,466,7,459,497,0.012
730,task_730,293,300,7,293,375,0.007
731,task_731,810,818,8,810,992,0.01
732,task_732,1313,1323,10,1311,1418,0.007
733,task_733,1070,1083,13,1055,1404,0.007
734,task_734,581,587,6,581,899,0.005
735,task_735,969,974,5,969,1030,0.012
736,task_736,36,46,10,36,131,0.011
737,task_737,313,323,10,311,1203,0.008
738,task_738,304,313,9,303,613,0.013
739,task_739,331,345,14,331,1270,0.007
740,task_740,112,125,13,112,589,0.005
741,task_741,235,249,14,235,698,0.014
742,task_742,805,817,12,801,1262,0.005
743,task_743,1169,1176,7,1169,1301,0.013
744,task_744,1403,1411,8,1399,1439,0.005
745,task_745,946,952,6,946,984,0.005
746,task_746,1292,1301,9,1292,1363,0.007
747,task_747,301,312,11,301,737,0.009
748,task_748,691,704,13,690,973,0.008
749,task_749,1399,1408,9,1398,1436,0.007
750,task_750,37,49,12,37,1203,0.011
751,task_751,541,552,11,540,969,0.014
752,task_752,829,838,9,828,1070,0.008
753,task_753,148,161,13,145,1097,0.006
754,task_754,347,359,12,347,1216,0.013
755,task_755,1159,1166,7,1159,1232,0.007
756,task_756,819,830,11,819,1059,0.01
757,task_757,200,213,13,200,585,0.014
758,task_758,938,946,8,932,1321,0.014
759,task_759,482,489,7,480,1192,0.013
760,task_760,675,685,10,672,986,0.013
761,task_761,831,844,13,829,1099,0.006
762,task_762,703,715,12,702,745,0.009
763,task_763,251,258,7,251,505,0.01
764,task_764,893,905,12,893,928,0.013
765,task_765,195,208,13,195,924,0.006
766,task_766,100,111,11,100,548,0.006
767,task_767,1055,1065,10,1055,1102,0.013
768,task_768,706,719,13,692,1382,0.007
769,task_769,318,323,5,318,1100,0.012
770,task_770,548,558,10,548,855,0.012
771,task_771,459,465,6,459,1394,0.008
772,task_772,258,267,9,258,392,0.008
773,task_773,1037,1047,10,1033,1273,0.008
774,task_774,1263,1269,6,1263,1380,0.014
775,task_775,1254,1262,8,1254,1305,0.01
776,task_776,577,589,12,577,1060,0.012
777,task_777,57,69,12,57,352,0.008
778,task_778,376,388,12,376,914,0.005
779,task_779,256,269,13,256,1343,0.01
780,task_780,1120,1126,6,1034,1416,0.013
781,task_781,92,105,13,92,1179,0.008
782,task_782,554,559,5,547,1221,0.011
783,task_783,75,87,12,75,865,0.007
784,task_784,495,505,10,495,1071,0.008
785,task_785,1061,1067,6,1061,1145,0.007
786,task_786,861,873,12,860,1323,0.012
787,task_787,435,440,5,435,1297,0.005
788,task_788,353,366,13,348,846,0.008
789,task_789,509,517,8,508,541,0.011
790,task_790,1048,1061,13,1046,1281,0.013
791,task_791,405,415,10,404,1191,0.005
792,task_792,246,255,9,246,394,0.013
793,task_793,354,366,12,353,973,0.013
794,task_794,1231,1244,13,1231,1265,0.01
795,task_795,1139,1144,5,1139,1182,0.005
796,task_796,431,441,10,431,1117,0.008
797,task_797,1038,1045,7,1038,1140,0.014
798,task_798,577,585,8,577,686,0.011
799,task_799,964,975,11,964,1282,0.007
800,task_800,896,907,11,896,1130,0.012
801,task_801,828,840,12,828,1045,0.011
802,task_802,554,567,13,547,1340,0.009
803,task_803,991,997,6,991,1065,0.011
804,task_804,208,221,13,208,1347,0.006
805,task_805,429,441,12,429,485,0.009
806,task_806,756,761,5,756,1233,0.007
807,task_807,666,675,9,665,1027,0.008
808,task_808,479,486,7,479,739,0.012
809,task_809,499,505,6,499,936,0.009
810,task_810,1014,1028,14,1014,1173,0.007
811,task_811,1152,1157,5,1152,1292,0.006
812,task_812,84,91,7,81,1075,0.007
813,task_813,759,764,5,759,999,0.01
814,task_814,341,354,13,341,905,0.013
815,task_815,541,547,6,540,785,0.011
816,task_816,1001,1011,10,1001,1251,0.014
817,task_817,298,309,11,298,751,0.012
818,task_818,1151,1158,7,1148,1402,0.008
819,task_819,12,20,8,12,152,0.01
820,task_820,1199,1208,9,1198,1378,0.01
821,task_821,1013,1019,6,1013,1153,0.008
822,task_822,745,757,12,745,903,0.005
823,task_823,761,775,14,760,896,0.009
824,task_824,983,990,7,845,1434,0.006
825,task_825,92,105,13,88,1186,0.008
826,task_826,1096,1101,5,1096,1176,0.006
827,task_827,567,578,11,566,847,0.014
828,task_828,301,306,5,301,477,0.012
829,task_829,379,384,5,379,642,0.011
830,task_830,360,370,10,357,1272,0.014
831,task_831,1155,1169,14,1155,1250,0.014
832,task_832,1065,1074,9,1062,1378,0.011
833,task_833,121,129,8,121,904,0.006
834,task_834,542,555,13,539,1212,0.012
835,task_835,413,423,10,355,1424,0.009
836,task_836,1112,1117,5,1111,1347,0.014
837,task_837,235,245,10,235,1004,0.005
838,task_838,1104,1117,13,1104,1287,0.012
839,task_839,1365,1375,10,1365,1431,0.006
840,task_840,743,753,10,738,1121,0.01
841,task_841,1222,1233,11,1222,1337,0.006
842,task_842,439,450,11,439,942,0.011
843,task_843,678,685,7,676,1369,0.012
844,task_844,1252,1261,9,1251,1361,0.007
845,task_845,1175,1188,13,1173,1371,0.009
846,task_846,1318,1329,11,1317,1417,0.008
847,task_847,1278,1288,10,1278,1370,0.007
848,task_848,291,304,13,291,1052,0.012
849,task_849,454,466,12,454,888,0.008
850,task_850,1339,1347,8,1339,1416,0.014
851,task_851,991,999,8,991,1018,0.013
852,task_852,388,398,10,388,1145,0.008
853,task_853,66,78,12,66,479,0.008
854,task_854,881,890,9,881,957,0.01
855,task_855,769,778,9,765,1371,0.008
856,task_856,159,170,11,159,561,0.005
857,task_857,1389,1399,10,1389,1417,0.012
858,task_858,1149,1154,5,1149,1367,0.01
859,task_859,1269,1283,14,1269,1360,0.01
860,task_860,107,119,12,106,1034,0.008
861,task_861,838,849,11,820,1236,0.008
862,task_862,687,695,8,687,1343,0.006
863,task_863,367,379,12,367,905,0.008
864,task_864,826,836,10,821,1029,0.007
865,task_865,1197,1210,13,1194,1362,0.01
866,task_866,154,161,7,153,385,0.006
867,task_867,917,927,10,915,1184,0.006
868,task_868,942,947,5,942,1208,0.005
869,task_869,244,249,5,244,264,0.014
870,task_870,48,58,10,48,380,0.01
871,task_871,719,725,6,698,1437,0.01
872,task_872,1006,1020,14,996,1353,0.014
873,task_873,1112,1120,8,1106,1346,0.013
874,task_874,946,951,5,946,1107,0.014
875,task_875,747,757,10,747,918,0.01
876,task_876,604,616,12,604,839,0.005
877,task_877,876,886,10,867,1423,0.007
878,task_878,224,235,11,224,992,0.013
879,task_879,1231,1240,9,1231,1290,0.006
880,task_880,1187,1201,14,1187,1428,0.011
881,task_881,861,868,7,860,1342,0.013
882,task_882,776,783,7,776,873,0.012
883,task_883,121,126,5,121,543,0.01
884,task_884,567,573,6,567,845,0.006
885,task_885,750,759,9,750,907,0.014
886,task_886,1204,1211,7,1204,1312,0.011
887,task_887,731,740,9,731,1285,0.011
888,task_888,380,393,13,370,1361,0.007
889,task_889,1385,1398,13,1385,1412,0.013
890,task_890,812,818,6,812,962,0.009
891,task_891,131,144,13,131,887,0.009
892,task_892,543,549,6,543,611,0.005
893,task_893,131,138,7,131,967,0.007
894,task_894,1404,1410,6,1384,1437,0.007
895,task_895,1095,1109,14,1085,1401,0.009
896,task_896,1161,1166,5,1160,1222,0.011
897,task_897,1021,1030,9,1002,1399,0.007
898,task_898,462,476,14,462,1238,0.008
899,task_899,711,725,14,711,852,0.007
900,task_900,998,1004,6,998,1298,0.011
901,task_901,543,554,11,543,992,0.005
902,task_902,385,390,5,360,1417,0.01
903,task_903,758,768,10,745,1388,0.013
904,task_904,465,470,5,464,963,0.01
905,task_905,1252,1260,8,1252,1369,0.009
906,task_906,92,100,8,92,315,0.008
907,task_907,862,873,11,828,1392,0.007
908,task_908,590,604,14,590,938,0.009
909,task_909,59,69,10,59,289,0.005
910,task_910,199,213,14,199,267,0.007
911,task_911,800,813,13,800,969,0.005
912,task_912,163,169,6,163,1131,0.008
913,task_913,863,870,7,794,1415,0.013
914,task_914,55,69,14,55,841,0.01
915,task_915,783,792,9,783,822,0.006
916,task_916,1284,1292,8,1284,1340,0.009
917,task_917,189,198,9,189,907,0.011
918,task_918,204,210,6,202,1060,0.005
919,task_919,556,564,8,556,586,0.012
920,task_920,781,791,10,781,1005,0.007
921,task_921,794,801,7,794,1180,0.014
922,task_922,65,79,14,61,851,0.008
923,task_923,149,154,5,149,989,0.005
924,task_924,1185,1191,6,1185,1291,0.012
925,task_925,479,486,7,479,792,0.014
926,task_926,1157,1170,13,1156,1341,0.007
927,task_927,8,20,12,8,60,0.005
928,task_928,1377,1383,6,1376,1420,0.014
929,task_929,1335,1346,11,1335,1367,0.008
930,task_930,717,729,12,713,1278,0.012
931,task_931,223,234,11,223,268,0.012
932,task_932,493,501,8,493,745,0.006
933,task_933,612,620,8,612,1244,0.011
934,task_934,250,261,11,250,1041,0.012
935,task_935,1238,1250,12,1238,1289,0.011
936,task_936,64,76,12,60,706,0.008
937,task_937,165,173,8,165,750,0.009
938,task_938,636,645,9,636,1164,0.011
939,task_939,533,538,5,492,1432,0.013
940,task_940,423,428,5,423,968,0.014
941,task_941,781,792,11,779,1212,0.011
942,task_942,375,385,10,373,677,0.014
943,task_943,1103,1112,9,1097,1342,0.011
944,task_944,395,407,12,394,1027,0.013
945,task_945,952,960,8,950,1299,0.011
946,task_946,723,731,8,723,865,0.009
947,task_947,1361,1373,12,1361,1424,0.008
948,task_948,1235,1242,7,1235,1277,0.006
949,task_949,331,343,12,331,1192,0.012
950,task_950,329,342,13,329,1365,0.009
951,task_951,871,882,11,871,1014,0.012
952,task_952,734,743,9,734,1018,0.01
953,task_953,672,679,7,672,813,0.006
954,task_954,614,624,10,614,1159,0.007
955,task_955,6,18,12,6,428,0.005
956,task_956,140,145,5,140,647,0.01
957,task_957,1135,1146,11,1132,1409,0.005
958,task_958,376,387,11,374,1078,0.011
959,task_959,882,891,9,882,995,0.012
960,task_960,959,965,6,959,1147,0.01
961,task_961,1086,1095,9,1086,1249,0.009
962,task_962,98,106,8,98,361,0.005
963,task_963,34,47,13,34,791,0.01
964,task_964,366,372,6,366,723,0.014
965,task_965,305,313,8,304,924,0.013
966,task_966,516,524,8,515,1130,0.007
967,task_967,1320,1328,8,1320,1364,0.011
968,task_968,184,198,14,184,392,0.006
969,task_969,1334,1339,5,1334,1388,0.009
970,task_970,878,885,7,877,1418,0.005
971,task_971,137,148,11,137,273,0.006
972,task_972,337,342,5,337,680,0.007
973,task_973,1125,1137,12,1125,1201,0.011
974,task_974,900,907,7,896,1234,0.014
975,task_975,664,676,12,664,703,0.008
976,task_976,100,107,7,100,1261,0.005
977,task_977,39,48,9,39,1060,0.007
978,task_978,1007,1021,14,1007,1093,0.014
979,task_979,789,803,14,788,911,0.013
980,task_980,1223,1232,9,1223,1273,0.005
981,task_981,581,587,6,581,1109,0.011
982,task_982,632,638,6,632,1114,0.005
983,task_983,818,823,5,818,1222,0.009
984,task_984,1021,1033,12,1017,1391,0.005
985,task_985,506,515,9,506,548,0.008
986,task_986,460,469,9,460,1056,0.006
987,task_987,878,888,10,872,1423,0.009
988,task_988,734,743,9,734,929,0.012
989,task_989,175,182,7,175,408,0.007
990,task_990,1217,1228,11,1217,1325,0.009
991,task_991,1216,1226,10,1216,1299,0.013
992,task_992,854,862,8,852,1143,0.01
993,task_993,245,255,10,245,348,0.005
994,task_994,325,332,7,325,737,0.006
995,task_995,1286,1299,13,1274,1417,0.006
996,task_996,680,690,10,680,795,0.007
997,task_997,1074,1081,7,1074,1388,0.012
998,task_998,999,1011,12,999,1183,0.006
999,task_999,990,998,8,990,1092,0.011
1000,task_1000,1365,1370,5,1365,1417,0.008
1001,task_1001,16,24,8,16,321,0.005
1002,task_1002,139,146,7,139,667,0.006
1003,task_1003,813,818,5,804,1350,0.009
1004,task_1004,802,812,10,802,1205,0.007
1005,task_1005,316,328,12,316,1161,0.01
1006,task_1006,988,1002,14,988,1162,0.006
1007,task_1007,638,645,7,638,792,0.007
1008,task_1008,620,628,8,620,669,0.009
1009,task_1009,734,744,10,734,892,0.01
1010,task_1010,504,517,13,504,830,0.007
1011,task_1011,926,940,14,926,1030,0.014
1012,task_1012,43,51,8,43,600,0.008
1013,task_1013,522,534,12,499,1379,0.005
1014,task_1014,1059,1069,10,1059,1150,0.01
1015,task_1015,1200,1213,13,1198,1416,0.014
1016,task_1016,1366,1377,11,1366,1397,0.011
1017,task_1017,505,514,9,483,1291,0.009
1018,task_1018,83,89,6,81,329,0.013
1019,task_1019,685,698,13,684,1431,0.01
1020,task_1020,1033,1043,10,1032,1081,0.006
1021,task_1021,1074,1081,7,1074,1352,0.006
1022,task_1022,549,555,6,549,1003,0.013
1023,task_1023,313,326,13,310,1173,0.009
1024,task_1024,17,30,13,17,363,0.006
1025,task_1025,956,964,8,955,1209,0.014
1026,task_1026,1129,1143,14,1124,1367,0.012
1027,task_1027,913,926,13,911,1074,0.01
1028,task_1028,614,628,14,614,1375,0.011
1029,task_1029,237,250,13,237,363,0.014
1030,task_1030,1110,1122,12,1107,1349,0.005
1031,task_1031,251,260,9,251,1033,0.005
1032,task_1032,848,857,9,831,1334,0.01
1033,task_1033,1073,1086,13,1073,1155,0.012
1034,task_1034,1014,1023,9,1012,1160,0.011
1035,task_1035,255,264,9,255,1032,0.014
1036,task_1036,1382,1396,14,1382,1437,0.007
1037,task_1037,104,116,12,104,340,0.008
1038,task_1038,878,891,13,878,1095,0.009
1039,task_1039,166,180,14,166,670,0.01
1040,task_1040,832,839,7,830,1098,0.014
1041,task_1041,135,142,7,135,724,0.006
1042,task_1042,1149,1157,8,1145,1317,0.012
1043,task_1043,1355,1360,5,1355,1407,0.01
1044,task_1044,1397,1406,9,1397,1428,0.009
1045,task_1045,733,743,10,733,1155,0.012
1046,task_1046,1205,1215,10,1205,1433,0.012
1047,task_1047,220,231,11,220,1101,0.007
1048,task_1048,1192,1197,5,1192,1263,0.005
1049,task_1049,947,956,9,943,1235,0.011
1050,task_1050,1176,1187,11,1176,1406,0.01
1051,task_1051,1345,1351,6,1345,1376,0.005
1052,task_1052,100,106,6,100,982,0.006
1053,task_1053,347,352,5,347,732,0.007
1054,task_1054,521,527,6,521,541,0.008
1055,task_1055,917,930,13,913,1252,0.009
1056,task_1056,913,920,7,913,1045,0.014
1057,task_1057,1211,1218,7,1211,1376,0.009
1058,task_1058,41,52,11,41,1357,0.009
1059,task_1059,117,125,8,117,673,0.007
1060,task_1060,838,850,12,834,1246,0.006
1061,task_1061,1302,1309,7,1302,1420,0.013
1062,task_1062,129,141,12,129,444,0.014
1063,task_1063,645,657,12,645,799,0.012
1064,task_1064,1187,1199,12,1187,1320,0.011
1065,task_1065,864,875,11,864,1072,0.005
1066,task_1066,695,705,10,695,869,0.014
1067,task_1067,202,207,5,202,311,0.013
1068,task_1068,1011,1021,10,1004,1381,0.01
1069,task_1069,1237,1243,6,1237,1258,0.014
1070,task_1070,1016,1029,13,1016,1267,0.014
1071,task_1071,1080,1091,11,1080,1140,0.007
1072,task_1072,1342,1349,7,1342,1436,0.013
1073,task_1073,32,39,7,32,1201,0.005
1074,task_1074,701,712,11,698,1307,0.009
1075,task_1075,1291,1300,9,1291,1402,0.01
1076,task_1076,276,284,8,276,951,0.005
1077,task_1077,1351,1357,6,1351,1390,0.014
1078,task_1078,1138,1146,8,1006,1430,0.006
1079,task_1079,1265,1278,13,1265,1379,0.005
1080,task_1080,786,799,13,779,1373,0.012
1081,task_1081,1025,1034,9,1024,1264,0.006
1082,task_1082,713,722,9,709,971,0.011
1083,task_1083,343,349,6,342,1177,0.011
1084,task_1084,1010,1017,7,1010,1100,0.014
1085,task_1085,664,676,12,660,969,0.013
1086,task_1086,115,120,5,115,975,0.007
1087,task_1087,251,258,7,251,1356,0.011
1088,task_1088,346,357,11,346,582,0.008
1089,task_1089,442,448,6,442,873,0.013
1090,task_1090,1078,1090,12,1077,1164,0.012
1091,task_1091,794,805,11,793,985,0.014
1092,task_1092,282,293,11,282,468,0.009
1093,task_1093,756,766,10,754,1185,0.011
1094,task_1094,889,900,11,889,1051,0.009
1095,task_1095,1288,1294,6,1284,1414,0.011
1096,task_1096,925,932,7,925,1026,0.011
1097,task_1097,818,823,5,818,1332,0.009
1098,task_1098,898,907,9,896,1210,0.009
1099,task_1099,1072,1084,12,1071,1393,0.006
1100,task_1100,190,204,14,190,1401,0.011
1101,task_1101,879,886,7,879,1011,0.012
1102,task_1102,486,492,6,481,1202,0.013
1103,task_1103,589,603,14,589,694,0.011
1104,task_1104,118,125,7,118,1432,0.011
1105,task_1105,147,161,14,147,616,0.008
1106,task_1106,321,327,6,321,604,0.008
1107,task_1107,221,228,7,221,937,0.011
1108,task_1108,1126,1134,8,1126,1282,0.014
1109,task_1109,61,72,11,61,402,0.008
1110,task_1110,727,739,12,727,811,0.012
1111,task_1111,819,826,7,819,1232,0.011
1112,task_1112,480,493,13,479,1180,0.008
1113,task_1113,691,705,14,690,1144,0.006
1114,task_1114,326,339,13,325,1133,0.005
1115,task_1115,201,210,9,201,803,0.007
1116,task_1116,1255,1267,12,1254,1436,0.013
1117,task_1117,385,392,7,361,1417,0.007
1118,task_1118,489,501,12,488,989,0.01
1119,task_1119,1146,1152,6,1146,1249,0.012
1120,task_1120,70,76,6,70,198,0.005
1121,task_1121,522,536,14,519,1427,0.012
1122,task_1122,697,706,9,697,1047,0.011
1123,task_1123,696,708,12,696,971,0.009
1124,task_1124,516,529,13,512,1221,0.013
1125,task_1125,20,34,14,20,113,0.011
1126,task_1126,257,267,10,257,946,0.008
1127,task_1127,249,259,10,248,471,0.007
1128,task_1128,793,806,13,793,889,0.01
1129,task_1129,63,69,6,62,456,0.008
1130,task_1130,893,905,12,893,1230,0.01
1131,task_1131,1226,1237,11,1226,1287,0.006
1132,task_1132,19,32,13,19,674,0.007
1133,task_1133,1196,1205,9,1196,1284,0.005
1134,task_1134,172,179,7,172,972,0.011
1135,task_1135,399,410,11,396,1169,0.009
1136,task_1136,611,620,9,611,974,0.014
1137,task_1137,898,907,9,897,1116,0.005
1138,task_1138,685,693,8,684,1340,0.011
1139,task_1139,1189,1194,5,1189,1243,0.013
1140,task_1140,13,27,14,13,192,0.011
1141,task_1141,700,706,6,700,745,0.012
1142,task_1142,936,945,9,936,1001,0.005
1143,task_1143,1125,1138,13,1125,1196,0.01
1144,task_1144,1066,1078,12,1059,1385,0.005
1145,task_1145,63,74,11,61,416,0.011
1146,task_1146,280,288,8,280,470,0.008
1147,task_1147,660,671,11,660,716,0.007
1148,task_1148,916,921,5,915,946,0.014
1149,task_1149,1394,1404,10,1394,1426,0.012
1150,task_1150,1062,1076,14,1062,1093,0.006
1151,task_1151,514,521,7,514,1007,0.006
1152,task_1152,1078,1088,10,1078,1102,0.012
1153,task_1153,1229,1237,8,1229,1297,0.005
1154,task_1154,361,367,6,356,1324,0.01
1155,task_1155,979,986,7,979,1385,0.006
1156,task_1156,383,396,13,381,845,0.012
1157,task_1157,510,516,6,510,649,0.014
1158,task_1158,393,401,8,389,1344,0.012
1159,task_1159,312,319,7,310,467,0.013
1160,task_1160,328,333,5,317,1373,0.005
1161,task_1161,1029,1043,14,1027,1325,0.014
1162,task_1162,573,586,13,573,675,0.01
1163,task_1163,1192,1199,7,1192,1223,0.005
1164,task_1164,763,774,11,763,834,0.009
1165,task_1165,1267,1280,13,1267,1438,0.012
1166,task_1166,838,849,11,830,1229,0.005
1167,task_1167,1385,1396,11,1385,1412,0.006
1168,task_1168,1365,1373,8,1365,1408,0.006
1169,task_1169,504,512,8,488,1284,0.013
1170,task_1170,585,590,5,585,1303,0.014
1171,task_1171,1105,1117,12,1047,1415,0.012
1172,task_1172,722,736,14,722,1295,0.01
1173,task_1173,1274,1279,5,1274,1301,0.008
1174,task_1174,1384,1393,9,1384,1408,0.005
1175,task_1175,215,226,11,215,548,0.01
1176,task_1176,1039,1044,5,1039,1156,0.01
1177,task_1177,1070,1078,8,1070,1259,0.01
1178,task_1178,221,228,7,221,387,0.008
1179,task_1179,891,900,9,879,1350,0.006
1180,task_1180,334,346,12,334,510,0.014
1181,task_1181,1187,1199,12,1187,1430,0.005
1182,task_1182,478,490,12,478,614,0.014
1183,task_1183,763,776,13,763,965,0.009
1184,task_1184,1172,1185,13,1172,1286,0.014
1185,task_1185,1004,1016,12,1004,1082,0.007
1186,task_1186,7,16,9,7,838,0.009
1187,task_1187,776,786,10,776,991,0.009
1188,task_1188,1268,1276,8,1268,1362,0.007
1189,task_1189,676,687,11,676,1042,0.007
1190,task_1190,934,941,7,934,1104,0.007
1191,task_1191,4,13,9,4,259,0.011
1192,task_1192,1025,1034,9,1024,1258,0.009
1193,task_1193,976,983,7,976,1115,0.011
1194,task_1194,807,817,10,796,1316,0.008
1195,task_1195,353,361,8,348,950,0.006
1196,task_1196,414,426,12,414,1288,0.014
1197,task_1197,1029,1034,5,1024,1308,0.012
1198,task_1198,122,129,7,122,1285,0.011
1199,task_1199,941,954,13,933,1397,0.011
1200,task_1200,1321,1333,12,1314,1436,0.01
1201,task_1201,187,201,14,187,814,0.005
1202,task_1202,1003,1015,12,1003,1249,0.006
1203,task_1203,185,193,8,185,1207,0.013
1204,task_1204,927,938,11,927,1082,0.012
1205,task_1205,518,524,6,518,1246,0.005
1206,task_1206,1284,1291,7,1283,1352,0.014
1207,task_1207,570,578,8,570,1105,0.006
1208,task_1208,1223,1237,14,1223,1275,0.006
1209,task_1209,1110,1119,9,1107,1203,0.009
1210,task_1210,298,307,9,298,901,0.012
1211,task_1211,743,757,14,740,1296,0.013
1212,task_1212,56,69,13,56,1369,0.006
1213,task_1213,1232,1239,7,1232,1397,0.014
1214,task_1214,617,630,13,617,1340,0.011
1215,task_1215,1199,1207,8,1196,1377,0.014
1216,task_1216,108,114,6,108,1297,0.01
1217,task_1217,1181,1187,6,1181,1373,0.008
1218,task_1218,873,882,9,873,1330,0.008
1219,task_1219,517,522,5,517,608,0.006
1220,task_1220,463,473,10,463,1101,0.012
1221,task_1221,589,601,12,589,1069,0.007
1222,task_1222,1084,1092,8,1082,1264,0.011
1223,task_1223,1320,1332,12,1320,1420,0.01
1224,task_1224,1068,1074,6,1068,1268,0.008
1225,task_1225,258,272,14,258,1009,0.01
1226,task_1226,685,691,6,670,1420,0.007
1227,task_1227,838,852,14,834,1206,0.005
1228,task_1228,488,494,6,488,761,0.013
1229,task_1229,956,966,10,956,1376,0.006
1230,task_1230,856,862,6,856,1144,0.014
1231,task_1231,992,1006,14,992,1316,0.011
1232,task_1232,956,968,12,956,1353,0.006
1233,task_1233,183,188,5,183,1077,0.007
1234,task_1234,613,624,11,613,1034,0.009
1235,task_1235,1092,1099,7,1092,1157,0.01
1236,task_1236,888,893,5,883,1300,0.012
1237,task_1237,78,83,5,78,962,0.009
1238,task_1238,752,766,14,752,993,0.006
1239,task_1239,1337,1343,6,1337,1392,0.006
1240,task_1240,1101,1106,5,1101,1161,0.008
1241,task_1241,1134,1143,9,1134,1225,0.008
1242,task_1242,1164,1178,14,1164,1291,0.008
1243,task_1243,753,763,10,750,1081,0.007
1244,task_1244,1250,1256,6,1249,1382,0.009
1245,task_1245,842,847,5,842,893,0.011
1246,task_1246,678,686,8,678,823,0.008
1247,task_1247,539,551,12,539,907,0.013
1248,task_1248,856,861,5,853,1237,0.011
1249,task_1249,559,570,11,559,1038,0.013
1250,task_1250,405,418,13,393,1422,0.006
1251,task_1251,142,155,13,142,303,0.007
1252,task_1252,135,148,13,135,777,0.013
1253,task_1253,291,298,7,291,757,0.007
1254,task_1254,136,143,7,136,925,0.005
1255,task_1255,448,460,12,448,737,0.011
1256,task_1256,128,141,13,128,1076,0.007
1257,task_1257,37,42,5,37,1324,0.012
1258,task_1258,975,985,10,975,1197,0.005
1259,task_1259,601,610,9,601,1253,0.011
1260,task_1260,1279,1290,11,1279,1408,0.01
1261,task_1261,947,956,9,946,1314,0.006
1262,task_1262,1122,1135,13,1090,1427,0.012
1263,task_1263,546,559,13,546,626,0.014
1264,task_1264,789,801,12,789,814,0.007
1265,task_1265,1149,1158,9,1149,1355,0.006
1266,task_1266,302,310,8,302,896,0.005
1267,task_1267,377,384,7,377,1123,0.014
1268,task_1268,1286,1300,14,1278,1417,0.014
1269,task_1269,829,837,8,829,1026,0.007
1270,task_1270,1051,1060,9,1049,1187,0.011
1271,task_1271,1137,1151,14,1137,1288,0.013
1272,task_1272,1111,1122,11,1111,1247,0.007
1273,task_1273,75,86,11,75,270,0.013
1274,task_1274,1020,1029,9,1014,1335,0.011
1275,task_1275,1170,1183,13,1169,1416,0.007
1276,task_1276,895,907,12,895,1110,0.005
1277,task_1277,41,51,10,41,895,0.007
1278,task_1278,949,962,13,949,1273,0.008
1279,task_1279,330,342,12,330,1006,0.012
1280,task_1280,968,973,5,966,1286,0.011
1281,task_1281,204,214,10,199,1019,0.013
1282,task_1282,248,260,12,248,469,0.01
1283,task_1283,265,276,11,265,1054,0.006
1284,task_1284,264,274,10,264,544,0.011
1285,task_1285,98,111,13,98,1097,0.012
1286,task_1286,125,133,8,125,754,0.01
1287,task_1287,326,333,7,324,1128,0.005
1288,task_1288,134,148,14,134,1175,0.009
1289,task_1289,328,337,9,328,1432,0.005
1290,task_1290,718,727,9,718,1187,0.014
1291,task_1291,596,605,9,596,1219,0.006
1292,task_1292,422,435,13,422,1010,0.011
1293,task_1293,921,931,10,910,1385,0.007
1294,task_1294,1216,1223,7,1216,1288,0.008
1295,task_1295,631,641,10,631,1265,0.011
1296,task_1296,489,503,14,486,1220,0.012
1297,task_1297,704,713,9,703,1220,0.008
1298,task_1298,974,983,9,970,1393,0.009
1299,task_1299,272,284,12,272,1356,0.013
1300,task_1300,237,247,10,237,532,0.008
1301,task_1301,890,898,8,890,1071,0.012
1302,task_1302,1019,1032,13,1019,1230,0.013
1303,task_1303,201,215,14,200,1007,0.009
1304,task_1304,305,317,12,305,568,0.005
1305,task_1305,263,269,6,262,627,0.012
1306,task_1306,384,395,11,383,1197,0.008
1307,task_1307,1176,1183,7,1176,1315,0.006
1308,task_1308,1364,1375,11,1364,1424,0.009
1309,task_1309,1089,1100,11,1088,1376,0.007
1310,task_1310,161,175,14,161,532,0.011
1311,task_1311,237,251,14,237,1089,0.013
1312,task_1312,1186,1192,6,1186,1285,0.011
1313,task_1313,1294,1301,7,1294,1349,0.006
1314,task_1314,300,306,6,300,538,0.012
1315,task_1315,181,188,7,181,540,0.007
1316,task_1316,212,217,5,212,972,0.011
1317,task_1317,956,967,11,956,1273,0.011
1318,task_1318,842,856,14,842,1165,0.013
1319,task_1319,606,616,10,606,1015,0.011
1320,task_1320,820,833,13,820,1112,0.009
1321,task_1321,1362,1372,10,1362,1384,0.007
1322,task_1322,349,357,8,348,429,0.012
1323,task_1323,512,517,5,511,782,0.009
1324,task_1324,155,166,11,155,595,0.008
1325,task_1325,956,964,8,955,1252,0.005
1326,task_1326,60,66,6,60,349,0.006
1327,task_1327,907,917,10,891,1393,0.012
1328,task_1328,644,655,11,643,1390,0.008
1329,task_1329,960,968,8,958,1262,0.011
1330,task_1330,1380,1389,9,1380,1400,0.011
1331,task_1331,80,93,13,80,396,0.01
1332,task_1332,265,275,10,262,708,0.012
1333,task_1333,1085,1090,5,1085,1274,0.006
1334,task_1334,853,864,11,853,1118,0.013
1335,task_1335,1336,1345,9,1336,1416,0.012
1336,task_1336,928,938,10,925,1301,0.006
1337,task_1337,186,195,9,186,516,0.011
1338,task_1338,1202,1214,12,1202,1304,0.007
1339,task_1339,302,308,6,302,937,0.013
1340,task_1340,1170,1181,11,1169,1412,0.005
1341,task_1341,475,487,12,475,1423,0.009
1342,task_1342,387,393,6,387,1317,0.013
1343,task_1343,950,959,9,950,1098,0.006
1344,task_1344,926,937,11,926,1018,0.009
1345,task_1345,669,681,12,667,1308,0.009
1346,task_1346,1364,1369,5,1364,1388,0.012
1347,task_1347,1196,1206,10,1196,1295,0.005
1348,task_1348,89,101,12,89,971,0.011
1349,task_1349,710,720,10,710,763,0.005
1350,task_1350,1040,1053,13,1038,1212,0.014
1351,task_1351,712,723,11,712,933,0.01
1352,task_1352,1172,1180,8,1172,1251,0.006
1353,task_1353,568,577,9,562,1409,0.012
1354,task_1354,784,797,13,784,861,0.008
1355,task_1355,651,664,13,651,974,0.011
1356,task_1356,945,957,12,945,1064,0.01
1357,task_1357,797,807,10,797,1059,0.014
1358,task_1358,1015,1029,14,1013,1212,0.005
1359,task_1359,431,444,13,431,772,0.011
1360,task_1360,319,332,13,319,1101,0.005
1361,task_1361,1158,1172,14,1155,1389,0.005
1362,task_1362,223,234,11,223,535,0.009
1363,task_1363,616,621,5,616,1141,0.01
1364,task_1364,281,291,10,280,943,0.006
1365,task_1365,1281,1287,6,1281,1334,0.009
1366,task_1366,105,115,10,104,347,0.005
1367,task_1367,1359,1365,6,1359,1412,0.005
1368,task_1368,127,137,10,127,1252,0.014
1369,task_1369,99,110,11,99,747,0.007
1370,task_1370,544,554,10,544,747,0.012
1371,task_1371,791,802,11,789,979,0.007
1372,task_1372,57,64,7,57,232,0.012
1373,task_1373,757,767,10,754,1329,0.013
1374,task_1374,681,688,7,680,887,0.01
1375,task_1375,1195,1200,5,1195,1317,0.007
1376,task_1376,1399,1408,9,1383,1436,0.013
1377,task_1377,268,281,13,268,948,0.014
1378,task_1378,719,731,12,717,1368,0.007
1379,task_1379,644,649,5,644,1221,0.011
1380,task_1380,1187,1193,6,1187,1278,0.009
1381,task_1381,293,302,9,293,603,0.011
1382,task_1382,12,21,9,12,1157,0.01
1383,task_1383,10,17,7,10,152,0.014
1384,task_1384,905,912,7,905,1203,0.006
1385,task_1385,630,643,13,630,1198,0.006
1386,task_1386,706,717,11,692,1432,0.014
1387,task_1387,629,635,6,629,884,0.011
1388,task_1388,1222,1227,5,1222,1237,0.01
1389,task_1389,898,909,11,898,1067,0.013
1390,task_1390,994,1007,13,994,1128,0.007
1391,task_1391,357,366,9,357,985,0.009
1392,task_1392,912,922,10,912,1063,0.008
1393,task_1393,977,983,6,977,1386,0.011
1394,task_1394,188,198,10,188,966,0.005
1395,task_1395,337,349,12,337,1134,0.014
1396,task_1396,545,554,9,545,627,0.007
1397,task_1397,159,170,11,159,564,0.012
1398,task_1398,1151,1161,10,1151,1300,0.011
1399,task_1399,137,148,11,137,978,0.009
1400,task_1400,554,568,14,546,1279,0.01
1401,task_1401,902,910,8,902,984,0.009
1402,task_1402,486,493,7,486,1116,0.009
1403,task_1403,53,58,5,53,377,0.011
1404,task_1404,183,197,14,183,1076,0.009
1405,task_1405,1123,1130,7,1123,1146,0.013
1406,task_1406,262,271,9,262,595,0.007
1407,task_1407,382,393,11,382,751,0.008
1408,task_1408,1368,1381,13,1368,1394,0.014
1409,task_1409,219,231,12,219,993,0.006
1410,task_1410,875,880,5,875,1218,0.009
1411,task_1411,143,149,6,143,1282,0.009
1412,task_1412,1043,1055,12,1040,1296,0.012
1413,task_1413,28,38,10,28,728,0.01
1414,task_1414,523,532,9,523,907,0.009
1415,task_1415,1068,1078,10,1042,1389,0.012
1416,task_1416,3,9,6,3,206,0.012
1417,task_1417,990,1003,13,990,1057,0.008
1418,task_1418,181,194,13,181,687,0.012
1419,task_1419,1329,1343,14,1327,1438,0.009
1420,task_1420,1050,1060,10,1049,1177,0.012
1421,task_1421,1127,1140,13,1127,1236,0.013
1422,task_1422,356,363,7,355,733,0.008
1423,task_1423,1270,1284,14,1270,1354,0.011
1424,task_1424,753,767,14,751,1189,0.007
1425,task_1425,148,156,8,147,1178,0.008
1426,task_1426,145,156,11,145,334,0.014
1427,task_1427,719,724,5,671,1438,0.012
1428,task_1428,936,950,14,936,1131,0.013
1429,task_1429,985,992,7,984,1132,0.01
1430,task_1430,749,755,6,748,910,0.008
1431,task_1431,767,775,8,767,1205,0.009
1432,task_1432,402,408,6,387,1401,0.005
1433,task_1433,272,282,10,272,995,0.007
1434,task_1434,120,134,14,120,1110,0.012
1435,task_1435,813,818,5,812,1292,0.005
1436,task_1436,582,593,11,582,961,0.008
1437,task_1437,159,164,5,159,387,0.01
1438,task_1438,1216,1221,5,1216,1416,0.011
1439,task_1439,693,700,7,693,818,0.007
1440,task_1440,393,405,12,393,443,0.005
1441,task_1441,771,782,11,770,1076,0.007
1442,task_1442,355,362,7,355,516,0.012
1443,task_1443,436,445,9,436,1160,0.005
1444,task_1444,221,228,7,221,1211,0.006
1445,task_1445,1307,1315,8,1307,1392,0.011
1446,task_1446,862,873,11,860,1387,0.012
1447,task_1447,1378,1385,7,1378,1431,0.006
1448,task_1448,947,961,14,947,1135,0.009
1449,task_1449,778,783,5,778,1047,0.014
1450,task_1450,1324,1334,10,1322,1430,0.014
1451,task_1451,465,470,5,465,1209,0.006
1452,task_1452,1304,1312,8,1304,1325,0.011
1453,task_1453,1372,1380,8,1371,1399,0.007
1454,task_1454,1061,1066,5,1035,1353,0.01
1455,task_1455,853,867,14,853,882,0.012
1456,task_1456,691,702,11,691,885,0.006
1457,task_1457,357,368,11,348,1201,0.01
1458,task_1458,115,126,11,111,1202,0.006
1459,task_1459,546,560,14,546,1068,0.005
1460,task_1460,408,416,8,408,862,0.011
1461,task_1461,86,98,12,85,399,0.014
1462,task_1462,432,443,11,432,596,0.009
1463,task_1463,108,118,10,108,1304,0.006
1464,task_1464,796,806,10,793,1220,0.01
1465,task_1465,427,436,9,427,641,0.005
1466,task_1466,659,667,8,652,1291,0.008
1467,task_1467,345,351,6,345,1043,0.009
1468,task_1468,45,50,5,45,1016,0.012
1469,task_1469,241,254,13,241,1365,0.009
1470,task_1470,678,685,7,678,1058,0.009
1471,task_1471,1287,1294,7,1287,1407,0.008
1472,task_1472,1183,1197,14,1183,1220,0.011
1473,task_1473,769,774,5,760,1361,0.01
1474,task_1474,372,379,7,363,1277,0.01
1475,task_1475,687,693,6,687,1224,0.007
1476,task_1476,904,917,13,904,1166,0.007
1477,task_1477,606,613,7,606,1128,0.013
1478,task_1478,411,417,6,411,1031,0.013
1479,task_1479,1349,1361,12,1349,1423,0.005
1480,task_1480,917,927,10,911,1173,0.006
1481,task_1481,1266,1277,11,1266,1386,0.008
1482,task_1482,1253,1263,10,1253,1389,0.008
1483,task_1483,1084,1097,13,1084,1143,0.007
1484,task_1484,177,189,12,177,1069,0.01
1485,task_1485,607,621,14,607,784,0.008
1486,task_1486,1150,1164,14,1150,1253,0.01
1487,task_1487,621,630,9,619,931,0.013
1488,task_1488,1078,1086,8,1078,1112,0.01
1489,task_1489,725,732,7,725,1180,0.008
1490,task_1490,521,535,14,521,1132,0.011
1491,task_1491,151,156,5,151,576,0.011
1492,task_1492,1270,1280,10,1270,1307,0.01
1493,task_1493,1382,1387,5,1382,1402,0.005
1494,task_1494,1141,1151,10,1141,1174,0.007
1495,task_1495,257,265,8,257,507,0.008
1496,task_1496,918,927,9,918,1220,0.005
1497,task_1497,691,700,9,689,1365,0.008
1498,task_1498,1080,1085,5,1079,1331,0.009
1499,task_1499,108,122,14,108,618,0.014
1500,task_1500,396,404,8,396,919,0.01
1501,task_1501,503,516,13,503,1246,0.013
1502,task_1502,530,544,14,493,1437,0.013
1503,task_1503,225,236,11,225,912,0.007
1504,task_1504,189,197,8,189,1057,0.011
1505,task_1505,726,734,8,726,1102,0.009
1506,task_1506,1287,1292,5,1287,1308,0.007
1507,task_1507,183,190,7,183,663,0.012
1508,task_1508,228,238,10,225,1383,0.01
1509,task_1509,1235,1240,5,1235,1420,0.013
1510,task_1510,326,338,12,324,1235,0.009
1511,task_1511,474,488,14,474,956,0.01
1512,task_1512,288,294,6,288,1132,0.013
1513,task_1513,5,10,5,5,1023,0.011
1514,task_1514,222,230,8,222,360,0.007
1515,task_1515,1362,1375,13,1362,1389,0.007
1516,task_1516,219,228,9,219,387,0.006
1517,task_1517,954,962,8,954,1341,0.011
1518,task_1518,1135,1148,13,1134,1369,0.008
1519,task_1519,807,817,10,796,1312,0.006
1520,task_1520,748,758,10,748,879,0.011
1521,task_1521,1237,1243,6,1237,1359,0.005
1522,task_1522,1055,1061,6,1048,1330,0.014
1523,task_1523,1391,1402,11,1390,1436,0.008
1524,task_1524,1078,1087,9,1078,1217,0.009
1525,task_1525,172,182,10,172,276,0.012
1526,task_1526,265,279,14,265,671,0.007
1527,task_1527,1173,1187,14,1173,1333,0.013
1528,task_1528,10,20,10,10,1048,0.012
1529,task_1529,850,855,5,832,1347,0.008
1530,task_1530,84,97,13,83,882,0.013
1531,task_1531,823,828,5,822,922,0.011
1532,task_1532,858,864,6,858,1329,0.008
1533,task_1533,850,858,8,829,1345,0.01
1534,task_1534,1179,1188,9,1179,1213,0.007
1535,task_1535,1062,1076,14,1062,1333,0.005
1536,task_1536,14,24,10,14,916,0.009
1537,task_1537,558,564,6,556,1035,0.008
1538,task_1538,246,252,6,246,853,0.005
1539,task_1539,1035,1048,13,1035,1153,0.005
1540,task_1540,1271,1277,6,1271,1299,0.007
1541,task_1541,1331,1342,11,1331,1427,0.008
1542,task_1542,459,467,8,459,1185,0.008
1543,task_1543,1247,1253,6,1247,1397,0.005
1544,task_1544,1339,1345,6,1339,1393,0.005
1545,task_1545,294,301,7,293,1134,0.006
1546,task_1546,340,354,14,340,748,0.008
1547,task_1547,588,601,13,588,855,0.006
1548,task_1548,1280,1294,14,1280,1341,0.007
1549,task_1549,327,334,7,323,1246,0.008
1550,task_1550,359,369,10,358,1187,0.009
1551,task_1551,532,543,11,531,772,0.011
1552,task_1552,483,489,6,483,773,0.007
1553,task_1553,148,155,7,145,1248,0.01
1554,task_1554,155,166,11,152,567,0.006
1555,task_1555,1307,1318,11,1307,1425,0.009
1556,task_1556,606,619,13,606,1284,0.013
1557,task_1557,357,363,6,357,847,0.007
1558,task_1558,650,658,8,650,828,0.007
1559,task_1559,1321,1334,13,1321,1410,0.011
1560,task_1560,788,794,6,788,888,0.006
1561,task_1561,262,272,10,262,533,0.012
1562,task_1562,1404,1412,8,1398,1439,0.006
1563,task_1563,422,427,5,421,1429,0.01
1564,task_1564,920,929,9,920,1221,0.008
1565,task_1565,612,626,14,612,1151,0.012
1566,task_1566,1312,1320,8,1312,1350,0.014
1567,task_1567,149,155,6,149,289,0.013
1568,task_1568,1157,1164,7,1156,1343,0.01
1569,task_1569,178,184,6,178,1013,0.005
1570,task_1570,867,872,5,867,1193,0.014
1571,task_1571,266,279,13,263,1368,0.013
1572,task_1572,776,787,11,776,1057,0.009
1573,task_1573,1283,1290,7,1283,1332,0.014
1574,task_1574,1369,1377,8,1369,1413,0.008
1575,task_1575,1043,1055,12,1043,1238,0.013
1576,task_1576,847,861,14,828,1328,0.011
1577,task_1577,961,969,8,961,1192,0.006
1578,task_1578,1248,1258,10,1248,1291,0.012
1579,task_1579,621,630,9,620,1352,0.008
1580,task_1580,136,149,13,136,689,0.013
1581,task_1581,518,523,5,518,1131,0.007
1582,task_1582,1029,1040,11,1023,1343,0.007
1583,task_1583,56,66,10,56,400,0.009
1584,task_1584,336,341,5,336,760,0.011
1585,task_1585,864,877,13,736,1427,0.011
1586,task_1586,503,509,6,499,1249,0.012
1587,task_1587,770,784,14,770,856,0.009
1588,task_1588,1289,1299,10,1289,1419,0.008
1589,task_1589,774,786,12,774,996,0.013
1590,task_1590,478,485,7,478,1359,0.007
1591,task_1591,76,84,8,76,847,0.012
1592,task_1592,1362,1373,11,1362,1434,0.006
1593,task_1593,1344,1357,13,1344,1429,0.013
1594,task_1594,823,837,14,822,961,0.005
1595,task_1595,307,312,5,306,1183,0.008
1596,task_1596,416,424,8,415,1358,0.006
1597,task_1597,279,289,10,278,1323,0.008
1598,task_1598,79,89,10,79,1153,0.014
1599,task_1599,557,569,12,557,729,0.007
1600,task_1600,683,694,11,682,789,0.006
1601,task_1601,75,80,5,75,1005,0.011
1602,task_1602,901,907,6,901,1326,0.014
1603,task_1603,517,523,6,506,1272,0.012
1604,task_1604,661,673,12,661,714,0.011
1605,task_1605,1059,1066,7,1057,1105,0.009
1606,task_1606,730,739,9,730,792,0.006
1607,task_1607,169,179,10,169,879,0.007
1608,task_1608,297,311,14,297,942,0.008
1609,task_1609,894,901,7,884,1382,0.01
1610,task_1610,692,701,9,692,920,0.008
1611,task_1611,1273,1281,8,1273,1408,0.007
1612,task_1612,154,166,12,152,311,0.012
1613,task_1613,203,212,9,203,779,0.008
1614,task_1614,696,708,12,696,860,0.012
1615,task_1615,938,944,6,938,1320,0.012
1616,task_1616,410,416,6,410,488,0.012
1617,task_1617,154,160,6,153,504,0.012
1618,task_1618,1300,1313,13,1283,1424,0.013
1619,task_1619,476,483,7,476,653,0.006
1620,task_1620,974,983,9,969,1348,0.008
1621,task_1621,384,397,13,381,1180,0.012
1622,task_1622,533,542,9,532,1312,0.011
1623,task_1623,1288,1297,9,1288,1343,0.006
1624,task_1624,1377,1384,7,1377,1402,0.007
1625,task_1625,535,543,8,535,1430,0.012
1626,task_1626,121,128,7,121,605,0.013
1627,task_1627,86,98,12,86,468,0.013
1628,task_1628,1365,1375,10,1365,1388,0.01
1629,task_1629,1236,1248,12,1236,1302,0.007
1630,task_1630,1302,1308,6,1285,1435,0.008
1631,task_1631,194,201,7,194,682,0.011
1632,task_1632,723,730,7,720,1405,0.012
1633,task_1633,37,45,8,37,869,0.005
1634,task_1634,1159,1171,12,1159,1219,0.008
1635,task_1635,1366,1379,13,1366,1421,0.008
1636,task_1636,302,313,11,302,766,0.011
1637,task_1637,890,900,10,890,1212,0.011
1638,task_1638,487,493,6,483,1206,0.01
1639,task_1639,1029,1037,8,1023,1332,0.005
1640,task_1640,577,583,6,577,938,0.011
1641,task_1641,776,787,11,776,1186,0.008
1642,task_1642,1340,1352,12,1340,1405,0.012
1643,task_1643,629,638,9,629,1256,0.009
1644,task_1644,474,481,7,474,997,0.01
1645,task_1645,1045,1055,10,1045,1293,0.007
1646,task_1646,1363,1374,11,1363,1435,0.011
1647,task_1647,257,267,10,257,865,0.013
1648,task_1648,810,819,9,810,1064,0.008
1649,task_1649,1199,1209,10,1194,1408,0.01
1650,task_1650,877,885,8,877,931,0.012
1651,task_1651,1375,1385,10,1372,1421,0.014
1652,task_1652,983,993,10,796,1435,0.013
1653,task_1653,875,885,10,874,1382,0.007
1654,task_1654,1281,1295,14,1280,1364,0.014
1655,task_1655,1170,1178,8,1170,1329,0.009
1656,task_1656,840,847,7,825,1260,0.012
1657,task_1657,307,313,6,306,1157,0.005
1658,task_1658,1152,1165,13,1152,1221,0.014
1659,task_1659,376,389,13,374,807,0.007
1660,task_1660,73,86,13,73,600,0.006
1661,task_1661,1378,1391,13,1375,1434,0.008
1662,task_1662,416,424,8,416,733,0.012
1663,task_1663,215,229,14,215,330,0.005
1664,task_1664,1191,1198,7,1191,1399,0.008
1665,task_1665,1295,1306,11,1294,1373,0.006
1666,task_1666,106,111,5,102,837,0.008
1667,task_1667,1329,1337,8,1329,1411,0.006
1668,task_1668,727,734,7,727,1173,0.008
1669,task_1669,786,800,14,784,1303,0.01
1670,task_1670,1266,1273,7,1266,1346,0.007
1671,task_1671,342,353,11,342,441,0.013
1672,task_1672,1074,1081,7,1074,1226,0.011
1673,task_1673,252,265,13,252,403,0.005
1674,task_1674,1146,1158,12,1145,1307,0.013
1675,task_1675,1286,1298,12,1274,1416,0.009
1676,task_1676,1011,1023,12,1008,1262,0.006
1677,task_1677,867,879,12,867,936,0.006
1678,task_1678,924,938,14,924,1296,0.014
1679,task_1679,473,485,12,473,1438,0.005
1680,task_1680,1375,1381,6,1372,1426,0.011
1681,task_1681,1081,1087,6,1081,1221,0.013
1682,task_1682,1008,1020,12,1008,1105,0.013
1683,task_1683,390,403,13,388,1257,0.008
1684,task_1684,1364,1378,14,1364,1423,0.013
1685,task_1685,805,819,14,795,1239,0.014
1686,task_1686,417,422,5,417,688,0.01
1687,task_1687,222,236,14,222,701,0.006
1688,task_1688,359,370,11,358,1185,0.006
1689,task_1689,401,406,5,401,767,0.005
1690,task_1690,16,28,12,16,731,0.006
1691,task_1691,1111,1118,7,1111,1148,0.012
1692,task_1692,423,429,6,423,1192,0.005
1693,task_1693,279,285,6,278,1260,0.014
1694,task_1694,516,521,5,506,1210,0.013
1695,task_1695,572,578,6,572,1007,0.007
1696,task_1696,1300,1311,11,1300,1405,0.007
1697,task_1697,244,254,10,244,541,0.006
1698,task_1698,575,586,11,575,1033,0.011
1699,task_1699,456,468,12,456,1402,0.012
1700,task_1700,838,850,12,837,1212,0.011
1701,task_1701,805,814,9,805,1019,0.008
1702,task_1702,517,523,6,501,1305,0.011
1703,task_1703,67,75,8,60,1243,0.007
1704,task_1704,1393,1407,14,1392,1425,0.005
1705,task_1705,927,941,14,926,1186,0.008
1706,task_1706,677,691,14,674,1287,0.014
1707,task_1707,804,813,9,804,850,0.006
1708,task_1708,1331,1345,14,1331,1372,0.009
1709,task_1709,1275,1285,10,1274,1337,0.011
1710,task_1710,689,694,5,689,990,0.005
1711,task_1711,1116,1125,9,1116,1306,0.007
1712,task_1712,537,544,7,537,1329,0.011
1713,task_1713,414,422,8,414,1210,0.005
1714,task_1714,1150,1155,5,1147,1367,0.013
1715,task_1715,1006,1012,6,1005,1367,0.01
1716,task_1716,379,384,5,377,1342,0.006
1717,task_1717,513,519,6,510,963,0.007
1718,task_1718,287,300,13,287,1357,0.005
1719,task_1719,1031,1045,14,1031,1163,0.014
1720,task_1720,460,465,5,460,1219,0.009
1721,task_1721,1135,1144,9,1133,1360,0.006
1722,task_1722,708,716,8,707,1127,0.014
1723,task_1723,1062,1070,8,1025,1359,0.008
1724,task_1724,515,522,7,513,1063,0.014
1725,task_1725,496,502,6,496,525,0.01
1726,task_1726,881,893,12,880,906,0.01
1727,task_1727,300,312,12,300,807,0.012
1728,task_1728,729,736,7,729,1275,0.011
1729,task_1729,640,654,14,640,867,0.01
1730,task_1730,679,684,5,679,835,0.008
1731,task_1731,932,941,9,932,998,0.005
1732,task_1732,1051,1065,14,1049,1314,0.012
1733,task_1733,430,439,9,430,1270,0.006
1734,task_1734,34,46,12,34,973,0.007
1735,task_1735,766,778,12,763,1106,0.012
1736,task_1736,912,917,5,912,1023,0.006
1737,task_1737,1184,1194,10,1184,1266,0.007
1738,task_1738,327,333,6,326,1338,0.013
1739,task_1739,164,173,9,164,456,0.005
1740,task_1740,928,938,10,775,1426,0.009
1741,task_1741,1262,1271,9,1262,1344,0.005
1742,task_1742,1208,1222,14,1208,1378,0.005
1743,task_1743,23,32,9,23,640,0.007
1744,task_1744,1198,1207,9,1197,1358,0.012
1745,task_1745,1370,1382,12,1370,1419,0.011
1746,task_1746,722,733,11,722,1020,0.01
1747,task_1747,67,78,11,67,421,0.01
1748,task_1748,729,743,14,729,1399,0.009
1749,task_1749,349,359,10,348,640,0.009
1750,task_1750,1034,1048,14,1032,1091,0.011
1751,task_1751,836,848,12,835,1027,0.012
1752,task_1752,815,828,13,815,975,0.014
1753,task_1753,621,627,6,621,952,0.009
1754,task_1754,1001,1015,14,1001,1200,0.009
1755,task_1755,222,231,9,222,631,0.006
1756,task_1756,640,650,10,640,1205,0.012
1757,task_1757,1379,1387,8,1379,1405,0.01
1758,task_1758,490,497,7,480,1265,0.011
1759,task_1759,1110,1119,9,1106,1298,0.012
1760,task_1760,765,776,11,765,965,0.01
1761,task_1761,1320,1334,14,1320,1433,0.012
1762,task_1762,292,297,5,292,569,0.014
1763,task_1763,462,474,12,462,1030,0.008
1764,task_1764,1243,1255,12,1243,1432,0.01
1765,task_1765,916,927,11,916,1134,0.01
1766,task_1766,595,605,10,595,1373,0.011
1767,task_1767,1359,1368,9,1359,1381,0.01
1768,task_1768,650,661,11,649,1135,0.005
1769,task_1769,493,499,6,492,1241,0.012
1770,task_1770,1144,1156,12,1144,1317,0.01
1771,task_1771,962,973,11,957,1377,0.01
1772,task_1772,310,322,12,310,413,0.005
1773,task_1773,813,819,6,812,1192,0.009
1774,task_1774,789,801,12,789,886,0.006
1775,task_1775,823,832,9,823,908,0.011
1776,task_1776,173,182,9,173,264,0.011
1777,task_1777,125,136,11,124,862,0.012
1778,task_1778,196,210,14,194,1225,0.012
1779,task_1779,185,193,8,185,571,0.007
1780,task_1780,456,464,8,456,784,0.009
1781,task_1781,192,206,14,192,1000,0.007
1782,task_1782,1037,1051,14,1036,1289,0.008
1783,task_1783,833,842,9,823,1205,0.011
1784,task_1784,273,287,14,273,845,0.011
1785,task_1785,1156,1162,6,1156,1186,0.005
1786,task_1786,1285,1296,11,1285,1371,0.007
1787,task_1787,51,59,8,51,1326,0.009
1788,task_1788,629,638,9,629,1357,0.01
1789,task_1789,1258,1268,10,1258,1328,0.005
1790,task_1790,1036,1041,5,1036,1238,0.005
1791,task_1791,608,614,6,608,973,0.01
1792,task_1792,1110,1115,5,1107,1207,0.009
1793,task_1793,0,11,11,0,1370,0.009
1794,task_1794,451,460,9,451,669,0.014
1795,task_1795,1387,1398,11,1385,1432,0.012
1796,task_1796,562,569,7,560,1129,0.012
1797,task_1797,850,862,12,850,959,0.011
1798,task_1798,1246,1254,8,1246,1330,0.006
1799,task_1799,53,67,14,53,733,0.008
1800,task_1800,659,666,7,653,1375,0.009
1801,task_1801,30,38,8,30,419,0.007
1802,task_1802,1116,1126,10,1113,1331,0.011
1803,task_1803,354,361,7,353,1117,0.01
1804,task_1804,675,681,6,672,982,0.007
1805,task_1805,647,658,11,647,801,0.007
1806,task_1806,687,696,9,687,1293,0.006
1807,task_1807,676,690,14,676,990,0.008
1808,task_1808,1015,1027,12,1015,1075,0.008
1809,task_1809,107,119,12,107,833,0.013
1810,task_1810,918,931,13,918,1130,0.008
1811,task_1811,654,664,10,652,712,0.005
1812,task_1812,249,257,8,249,1362,0.005
1813,task_1813,655,664,9,651,1089,0.01
1814,task_1814,79,93,14,79,220,0.005
1815,task_1815,121,133,12,121,964,0.006
1816,task_1816,1172,1177,5,1172,1261,0.013
1817,task_1817,1072,1079,7,1072,1287,0.006
1818,task_1818,223,229,6,223,1246,0.013
1819,task_1819,529,539,10,529,1051,0.009
1820,task_1820,1117,1124,7,1108,1394,0.008
1821,task_1821,416,425,9,416,685,0.011
1822,task_1822,528,541,13,527,606,0.011
1823,task_1823,858,869,11,858,1075,0.012
1824,task_1824,478,492,14,478,1405,0.01
1825,task_1825,1390,1395,5,1390,1414,0.008
1826,task_1826,1299,1312,13,1291,1420,0.009
1827,task_1827,102,111,9,102,534,0.014
1828,task_1828,114,123,9,114,653,0.006
1829,task_1829,1276,1289,13,1276,1309,0.013
1830,task_1830,144,151,7,144,378,0.009
1831,task_1831,727,736,9,727,1329,0.012
1832,task_1832,1279,1290,11,1279,1360,0.011
1833,task_1833,655,662,7,655,856,0.008
1834,task_1834,966,980,14,966,1259,0.01
1835,task_1835,183,188,5,183,960,0.008
1836,task_1836,440,446,6,440,1166,0.01
1837,task_1837,1002,1008,6,1002,1188,0.005
1838,task_1838,569,578,9,569,1435,0.011
1839,task_1839,813,820,7,813,1349,0.011
1840,task_1840,845,858,13,842,1239,0.01
1841,task_1841,1146,1159,13,1145,1216,0.014
1842,task_1842,841,850,9,841,1003,0.014
1843,task_1843,45,54,9,45,738,0.005
1844,task_1844,1269,1283,14,1269,1407,0.01
1845,task_1845,757,770,13,745,1307,0.009
1846,task_1846,51,65,14,51,504,0.01
1847,task_1847,463,472,9,463,1006,0.013
1848,task_1848,210,221,11,210,1261,0.007
1849,task_1849,1328,1334,6,1328,1396,0.013
1850,task_1850,431,438,7,431,1239,0.005
1851,task_1851,869,874,5,869,1264,0.006
1852,task_1852,643,655,12,643,861,0.012
1853,task_1853,375,382,7,375,665,0.011
1854,task_1854,319,331,12,319,545,0.014
1855,task_1855,1184,1198,14,1184,1286,0.007
1856,task_1856,499,511,12,498,878,0.008
1857,task_1857,782,794,12,778,1257,0.012
1858,task_1858,857,866,9,835,1369,0.009
1859,task_1859,229,234,5,226,1416,0.013
1860,task_1860,879,886,7,879,1013,0.012
1861,task_1861,1201,1209,8,1201,1248,0.006
1862,task_1862,483,492,9,483,754,0.009
1863,task_1863,976,982,6,975,1422,0.011
1864,task_1864,705,713,8,705,904,0.012
1865,task_1865,1060,1068,8,1057,1339,0.014
1866,task_1866,455,466,11,455,1387,0.012
1867,task_1867,514,520,6,514,548,0.005
1868,task_1868,407,414,7,407,584,0.014
1869,task_1869,722,734,12,722,1356,0.005
1870,task_1870,258,272,14,258,413,0.01
1871,task_1871,992,1000,8,991,1077,0.008
1872,task_1872,519,528,9,519,611,0.014
1873,task_1873,1317,1330,13,1316,1356,0.014
1874,task_1874,794,800,6,794,956,0.007
1875,task_1875,56,67,11,56,429,0.011
1876,task_1876,944,958,14,943,1078,0.011
1877,task_1877,777,784,7,750,1410,0.012
1878,task_1878,498,508,10,498,779,0.009
1879,task_1879,794,802,8,793,1021,0.006
1880,task_1880,644,656,12,644,1408,0.009
1881,task_1881,374,380,6,374,647,0.011
1882,task_1882,345,358,13,344,1417,0.008
1883,task_1883,905,916,11,903,1367,0.012
1884,task_1884,965,975,10,964,1390,0.009
1885,task_1885,206,211,5,202,1168,0.012
1886,task_1886,837,845,8,834,1115,0.008
1887,task_1887,55,65,10,55,504,0.01
1888,task_1888,77,88,11,77,593,0.007
1889,task_1889,397,405,8,397,448,0.014
1890,task_1890,811,818,7,809,1322,0.01
1891,task_1891,799,813,14,799,871,0.01
1892,task_1892,971,979,8,971,1267,0.011
1893,task_1893,1068,1080,12,1060,1391,0.008
1894,task_1894,1033,1045,12,1033,1067,0.008
1895,task_1895,269,276,7,269,680,0.006
1896,task_1896,1343,1357,14,1343,1415,0.01
1897,task_1897,1096,1103,7,1060,1409,0.011
1898,task_1898,419,426,7,419,1036,0.007
1899,task_1899,1206,1212,6,1206,1406,0.011
1900,task_1900,429,440,11,429,602,0.01
1901,task_1901,1146,1152,6,1145,1304,0.012
1902,task_1902,940,949,9,940,1188,0.013
1903,task_1903,950,964,14,950,994,0.006
1904,task_1904,11,17,6,11,1391,0.007
1905,task_1905,168,181,13,168,870,0.008
1906,task_1906,568,576,8,566,1219,0.013
1907,task_1907,231,241,10,231,277,0.014
1908,task_1908,794,799,5,793,1060,0.005
1909,task_1909,78,84,6,78,748,0.011
1910,task_1910,1130,1140,10,1007,1424,0.013
1911,task_1911,349,360,11,349,511,0.009
1912,task_1912,554,567,13,550,1204,0.013
1913,task_1913,659,670,11,649,1321,0.007
1914,task_1914,1268,1278,10,1268,1370,0.01
1915,task_1915,323,329,6,322,606,0.013
1916,task_1916,559,571,12,558,1180,0.009
1917,task_1917,172,180,8,172,1043,0.009
1918,task_1918,429,441,12,429,1304,0.008
1919,task_1919,878,890,12,878,945,0.008
1920,task_1920,801,810,9,800,1123,0.011
1921,task_1921,134,148,14,134,884,0.014
1922,task_1922,1177,1182,5,1177,1436,0.009
1923,task_1923,150,155,5,150,525,0.01
1924,task_1924,116,130,14,116,1319,0.008
1925,task_1925,187,195,8,187,481,0.007
1926,task_1926,428,441,13,428,488,0.013
1927,task_1927,1327,1341,14,1327,1409,0.006
1928,task_1928,1208,1215,7,1208,1316,0.012
1929,task_1929,427,434,7,427,847,0.01
1930,task_1930,524,538,14,524,719,0.008
1931,task_1931,490,495,5,486,1227,0.01
1932,task_1932,1094,1100,6,1094,1323,0.007
1933,task_1933,135,143,8,135,935,0.012
1934,task_1934,93,102,9,89,1306,0.009
1935,task_1935,143,151,8,143,169,0.009
1936,task_1936,229,235,6,229,1412,0.012
1937,task_1937,792,803,11,788,1150,0.011
1938,task_1938,409,417,8,409,1114,0.012
1939,task_1939,891,898,7,883,1342,0.006
1940,task_1940,768,773,5,763,1279,0.007
1941,task_1941,677,685,8,677,909,0.007
1942,task_1942,501,510,9,500,1160,0.013
1943,task_1943,1106,1116,10,1106,1210,0.012
1944,task_1944,856,866,10,855,1275,0.009
1945,task_1945,1037,1043,6,1032,1269,0.011
1946,task_1946,1078,1089,11,1077,1142,0.013
1947,task_1947,720,725,5,720,1227,0.012
1948,task_1948,941,948,7,932,1411,0.006
1949,task_1949,1314,1320,6,1314,1403,0.01
1950,task_1950,308,315,7,308,1048,0.012
1951,task_1951,1076,1084,8,1057,1404,0.011
1952,task_1952,99,107,8,99,787,0.014
1953,task_1953,523,532,9,482,1428,0.011
1954,task_1954,122,127,5,122,757,0.009
1955,task_1955,1209,1221,12,1209,1265,0.008
1956,task_1956,705,711,6,705,1058,0.009
1957,task_1957,980,993,13,980,1405,0.008
1958,task_1958,328,340,12,328,1048,0.009
1959,task_1959,1149,1162,13,1148,1365,0.008
1960,task_1960,288,293,5,288,888,0.012
1961,task_1961,502,516,14,502,546,0.009
1962,task_1962,1236,1241,5,1236,1351,0.005
1963,task_1963,978,983,5,978,1330,0.014
1964,task_1964,247,258,11,247,927,0.01
1965,task_1965,265,279,14,265,333,0.006
1966,task_1966,1395,1406,11,1395,1427,0.014
1967,task_1967,106,118,12,106,209,0.01
1968,task_1968,164,178,14,164,851,0.011
1969,task_1969,1317,1326,9,1317,1361,0.013
1970,task_1970,737,749,12,737,1119,0.014
1971,task_1971,1122,1135,13,1121,1368,0.009
1972,task_1972,1115,1122,7,1115,1191,0.006
1973,task_1973,1355,1365,10,1355,1385,0.007
1974,task_1974,402,416,14,396,1415,0.011
1975,task_1975,246,253,7,246,270,0.008
1976,task_1976,402,412,10,402,450,0.008
1977,task_1977,1240,1248,8,1240,1375,0.011
1978,task_1978,953,961,8,953,1364,0.006
1979,task_1979,749,754,5,748,958,0.013
1980,task_1980,579,584,5,579,662,0.008
1981,task_1981,1105,1110,5,1098,1407,0.008
1982,task_1982,935,942,7,935,1057,0.01
1983,task_1983,1007,1016,9,1003,1378,0.011
1984,task_1984,1333,1343,10,1333,1402,0.01
1985,task_1985,462,473,11,462,551,0.012
1986,task_1986,1299,1306,7,1298,1397,0.012
1987,task_1987,1045,1053,8,1044,1279,0.01
1988,task_1988,31,42,11,31,848,0.013
1989,task_1989,298,304,6,298,347,0.011
1990,task_1990,339,353,14,339,985,0.012
1991,task_1991,1037,1043,6,1033,1303,0.013
1992,task_1992,885,896,11,883,1245,0.013
1993,task_1993,588,593,5,588,867,0.005
1994,task_1994,495,501,6,495,644,0.014
1995,task_1995,468,474,6,468,1061,0.005
1996,task_1996,1403,1410,7,1392,1437,0.005
1997,task_1997,685,690,5,677,1409,0.012
1998,task_1998,982,993,11,885,1435,0.013
1999,task_1999,1246,1260,14,1246,1280,0.005
2000,task_2000,536,549,13,536,1233,0.007
2001,task_2001,907,913,6,907,1117,0.007
2002,task_2002,908,917,9,908,1186,0.011
2003,task_2003,390,395,5,390,1014,0.009
2004,task_2004,140,150,10,140,1030,0.009
2005,task_2005,1313,1321,8,1310,1404,0.014
2006,task_2006,361,366,5,358,1324,0.012
2007,task_2007,736,743,7,735,1305,0.014
2008,task_2008,1105,1110,5,1050,1408,0.013
2009,task_2009,1201,1208,7,1201,1257,0.005
2010,task_2010,1197,1209,12,1197,1290,0.008
2011,task_2011,623,629,6,623,1415,0.009
2012,task_2012,1375,1387,12,1375,1399,0.012
2013,task_2013,1121,1131,10,1121,1175,0.01
2014,task_2014,1095,1108,13,1092,1348,0.01
2015,task_2015,850,859,9,850,1185,0.014
2016,task_2016,597,608,11,597,807,0.012
2017,task_2017,1034,1043,9,1033,1115,0.006
2018,task_2018,377,384,7,363,1287,0.014
2019,task_2019,1047,1061,14,1046,1236,0.01
2020,task_2020,1004,1009,5,1004,1248,0.005
2021,task_2021,630,638,8,630,736,0.011
2022,task_2022,1367,1379,12,1367,1420,0.008
2023,task_2023,1020,1029,9,1015,1353,0.01
2024,task_2024,1263,1272,9,1263,1316,0.009
2025,task_2025,1234,1242,8,1234,1413,0.014
2026,task_2026,632,641,9,632,867,0.005
2027,task_2027,294,307,13,294,993,0.009
2028,task_2028,148,160,12,147,999,0.013
2029,task_2029,1332,1338,6,1332,1368,0.007
2030,task_2030,707,717,10,707,812,0.005
2031,task_2031,16,29,13,16,637,0.01
2032,task_2032,1396,1407,11,1396,1422,0.012
2033,task_2033,289,299,10,289,581,0.013
2034,task_2034,277,289,12,277,479,0.013
2035,task_2035,1170,1178,8,1167,1415,0.007
2036,task_2036,1124,1135,11,1123,1192,0.014
2037,task_2037,905,912,7,905,1175,0.007
2038,task_2038,44,56,12,44,938,0.009
2039,task_2039,1119,1130,11,1015,1418,0.005
2040,task_2040,783,792,9,783,993,0.011
2041,task_2041,342,350,8,342,911,0.011
2042,task_2042,980,985,5,736,1427,0.009
2043,task_2043,1220,1228,8,1220,1360,0.01
2044,task_2044,304,318,14,304,452,0.008
2045,task_2045,58,63,5,58,167,0.012
2046,task_2046,1078,1089,11,1077,1271,0.01
2047,task_2047,182,191,9,182,215,0.006
2048,task_2048,568,575,7,566,1354,0.013
2049,task_2049,3,14,11,3,49,0.009
2050,task_2050,833,838,5,832,1187,0.006
2051,task_2051,798,805,7,798,1012,0.011
2052,task_2052,1398,1406,8,1398,1424,0.012
2053,task_2053,997,1008,11,996,1319,0.012
2054,task_2054,1035,1043,8,1035,1131,0.012
2055,task_2055,841,853,12,824,1273,0.013
2056,task_2056,593,598,5,593,1134,0.005
2057,task_2057,1203,1214,11,1203,1415,0.007
2058,task_2058,98,108,10,98,1098,0.007
2059,task_2059,982,992,10,981,1276,0.011
2060,task_2060,380,387,7,380,769,0.009
2061,task_2061,869,879,10,866,1274,0.013
2062,task_2062,223,230,7,223,1332,0.006
2063,task_2063,635,646,11,635,759,0.012
2064,task_2064,354,364,10,354,645,0.011
2065,task_2065,1061,1066,5,1060,1345,0.013
2066,task_2066,504,515,11,504,1005,0.005
2067,task_2067,470,483,13,470,726,0.014
2068,task_2068,433,438,5,432,996,0.006
2069,task_2069,228,241,13,228,1144,0.013
2070,task_2070,673,679,6,672,880,0.012
2071,task_2071,1029,1038,9,1023,1313,0.006
2072,task_2072,1256,1263,7,1256,1423,0.008
2073,task_2073,592,603,11,592,1037,0.01
2074,task_2074,274,281,7,274,1225,0.009
2075,task_2075,1390,1403,13,1390,1424,0.014
2076,task_2076,147,158,11,146,293,0.013
2077,task_2077,973,980,7,973,1265,0.014
2078,task_2078,616,630,14,616,657,0.009
2079,task_2079,529,541,12,529,572,0.013
2080,task_2080,314,328,14,314,870,0.008
2081,task_2081,561,572,11,560,857,0.012
2082,task_2082,1306,1314,8,1303,1379,0.009
2083,task_2083,353,361,8,353,414,0.011
2084,task_2084,515,528,13,509,1082,0.01
2085,task_2085,464,473,9,464,639,0.013
2086,task_2086,418,428,10,418,1409,0.012
2087,task_2087,535,540,5,479,1435,0.006
2088,task_2088,1288,1302,14,1288,1373,0.012
2089,task_2089,555,561,6,547,1397,0.012
2090,task_2090,878,889,11,878,1151,0.013
2091,task_2091,827,835,8,821,1098,0.012
2092,task_2092,281,290,9,281,921,0.011
2093,task_2093,93,106,13,87,1389,0.008
2094,task_2094,1334,1341,7,1334,1393,0.012
2095,task_2095,1251,1260,9,1251,1321,0.013
2096,task_2096,1137,1146,9,1137,1361,0.014
2097,task_2097,191,196,5,191,618,0.008
2098,task_2098,1239,1244,5,1239,1437,0.008
2099,task_2099,1318,1324,6,1316,1363,0.008
2100,task_2100,644,658,14,643,1363,0.011
2101,task_2101,571,581,10,571,1267,0.007
2102,task_2102,1387,1401,14,1385,1431,0.005
2103,task_2103,728,734,6,728,1395,0.012
2104,task_2104,744,756,12,741,1402,0.011
2105,task_2105,1309,1321,12,1309,1335,0.013
2106,task_2106,787,794,7,782,1384,0.013
2107,task_2107,856,868,12,851,1311,0.005
2108,task_2108,160,173,13,160,1155,0.008
2109,task_2109,1048,1060,12,1048,1253,0.009
2110,task_2110,826,840,14,825,995,0.011
2111,task_2111,1391,1397,6,1391,1410,0.011
2112,task_2112,525,537,12,525,581,0.009
2113,task_2113,894,904,10,890,1383,0.005
2114,task_2114,526,532,6,524,866,0.011
2115,task_2115,983,988,5,971,1436,0.006
2116,task_2116,1383,1389,6,1383,1424,0.013
2117,task_2117,20,34,14,20,906,0.009
2118,task_2118,406,411,5,406,1052,0.009
2119,task_2119,291,296,5,291,1333,0.014
2120,task_2120,1047,1060,13,1047,1255,0.007
2121,task_2121,453,461,8,453,627,0.007
2122,task_2122,1199,1207,8,1198,1358,0.009
2123,task_2123,552,558,6,549,1150,0.009
2124,task_2124,1367,1380,13,1367,1429,0.008
2125,task_2125,881,893,12,880,986,0.01
2126,task_2126,510,516,6,506,858,0.012
2127,task_2127,245,250,5,245,484,0.007
2128,task_2128,1089,1095,6,1089,1215,0.011
2129,task_2129,339,345,6,339,492,0.01
2130,task_2130,406,411,5,406,777,0.011
2131,task_2131,159,173,14,159,703,0.012
2132,task_2132,1148,1154,6,1148,1276,0.007
2133,task_2133,1367,1378,11,1367,1405,0.006
2134,task_2134,433,440,7,432,673,0.008
2135,task_2135,316,326,10,301,1242,0.009
2136,task_2136,356,361,5,356,1101,0.007
2137,task_2137,1000,1005,5,1000,1068,0.006
2138,task_2138,736,750,14,736,1153,0.008
2139,task_2139,1113,1124,11,1113,1147,0.013
2140,task_2140,993,1007,14,993,1281,0.007
2141,task_2141,79,88,9,79,125,0.014
2142,task_2142,1043,1056,13,1042,1170,0.005
2143,task_2143,544,549,5,544,1437,0.005
2144,task_2144,469,476,7,469,1255,0.007
2145,task_2145,1273,1286,13,1273,1305,0.01
2146,task_2146,369,377,8,369,653,0.009
2147,task_2147,753,766,13,749,1105,0.009
2148,task_2148,545,552,7,545,865,0.009
2149,task_2149,681,695,14,681,1294,0.011
2150,task_2150,511,523,12,511,554,0.008
2151,task_2151,1358,1365,7,1358,1396,0.005
2152,task_2152,393,399,6,391,1118,0.007
2153,task_2153,328,339,11,328,529,0.005
2154,task_2154,667,680,13,666,1264,0.006
2155,task_2155,971,984,13,971,1214,0.006
2156,task_2156,1152,1161,9,1152,1185,0.005
2157,task_2157,951,963,12,950,1196,0.012
2158,task_2158,998,1007,9,998,1103,0.005
2159,task_2159,417,426,9,417,1339,0.005
2160,task_2160,473,482,9,473,527,0.01
2161,task_2161,716,722,6,714,1175,0.014
2162,task_2162,691,697,6,688,1296,0.009
2163,task_2163,1151,1157,6,1145,1368,0.01
2164,task_2164,414,423,9,414,814,0.011
2165,task_2165,405,416,11,404,1180,0.011
2166,task_2166,103,112,9,103,618,0.013
2167,task_2167,1023,1030,7,1023,1087,0.008
2168,task_2168,171,180,9,171,545,0.005
2169,task_2169,638,644,6,638,1376,0.008
2170,task_2170,1138,1149,11,1066,1432,0.009
2171,task_2171,390,397,7,390,616,0.012
2172,task_2172,1302,1307,5,1302,1377,0.011
2173,task_2173,1020,1031,11,1019,1296,0.011
2174,task_2174,1294,1306,12,1294,1348,0.013
2175,task_2175,261,268,7,261,1134,0.012
2176,task_2176,1096,1110,14,1096,1301,0.012
2177,task_2177,1305,1317,12,1305,1349,0.011
2178,task_2178,664,678,14,661,1162,0.005
2179,task_2179,399,410,11,399,546,0.01
2180,task_2180,669,678,9,668,854,0.007
2181,task_2181,993,1001,8,993,1098,0.01
2182,task_2182,87,100,13,87,1116,0.014
2183,task_2183,859,864,5,837,1371,0.009
2184,task_2184,1397,1406,9,1396,1429,0.007
2185,task_2185,835,845,10,834,975,0.01
2186,task_2186,1245,1252,7,1245,1412,0.014
2187,task_2187,615,627,12,615,1141,0.009
2188,task_2188,630,642,12,630,826,0.014
2189,task_2189,734,747,13,734,1183,0.012
2190,task_2190,1137,1144,7,1137,1408,0.005
2191,task_2191,966,979,13,966,1077,0.008
2192,task_2192,602,609,7,602,1237,0.011
2193,task_2193,785,794,9,785,1212,0.014
2194,task_2194,237,251,14,237,913,0.009
2195,task_2195,513,518,5,512,1006,0.009
2196,task_2196,1279,1293,14,1279,1364,0.006
2197,task_2197,983,996,13,908,1437,0.009
2198,task_2198,320,329,9,293,1369,0.006
2199,task_2199,1244,1258,14,1244,1423,0.009
2200,task_2200,67,72,5,57,1180,0.013
2201,task_2201,860,867,7,860,1096,0.008
2202,task_2202,1355,1362,7,1355,1389,0.01
2203,task_2203,782,791,9,782,1030,0.007
2204,task_2204,635,641,6,635,713,0.006
2205,task_2205,481,495,14,481,671,0.012
2206,task_2206,1237,1249,12,1237,1331,0.011
2207,task_2207,1300,1306,6,1298,1421,0.009
2208,task_2208,204,215,11,204,299,0.011
2209,task_2209,178,185,7,178,1083,0.009
2210,task_2210,1030,1041,11,1030,1254,0.011
2211,task_2211,205,214,9,205,1139,0.01
2212,task_2212,917,924,7,910,1177,0.009
2213,task_2213,588,593,5,588,1033,0.008
2214,task_2214,436,450,14,436,665,0.008
2215,task_2215,941,952,11,933,1414,0.008
2216,task_2216,105,116,11,104,828,0.01
2217,task_2217,864,876,12,805,1426,0.007
2218,task_2218,188,196,8,188,965,0.006
2219,task_2219,25,30,5,25,810,0.01
2220,task_2220,1242,1255,13,1242,1272,0.008
2221,task_2221,1043,1055,12,1043,1144,0.007
2222,task_2222,420,433,13,420,735,0.014
2223,task_2223,923,928,5,923,1383,0.005
2224,task_2224,517,530,13,506,1325,0.01
2225,task_2225,1090,1098,8,1087,1391,0.008
2226,task_2226,952,961,9,950,1347,0.01
2227,task_2227,641,648,7,641,779,0.007
2228,task_2228,590,604,14,590,976,0.009
2229,task_2229,1236,1242,6,1236,1264,0.007
2230,task_2230,811,822,11,803,1327,0.013
2231,task_2231,999,1007,8,999,1195,0.011
2232,task_2232,500,507,7,500,768,0.009
2233,task_2233,404,415,11,404,895,0.01
2234,task_2234,489,503,14,489,1178,0.005
2235,task_2235,342,355,13,342,400,0.009
2236,task_2236,351,356,5,350,718,0.007
2237,task_2237,840,850,10,832,1249,0.013
2238,task_2238,489,503,14,488,829,0.007
2239,task_2239,1056,1064,8,1039,1339,0.007
2240,task_2240,433,439,6,433,655,0.005
2241,task_2241,1065,1070,5,1054,1374,0.005
2242,task_2242,1029,1040,11,1028,1054,0.013
2243,task_2243,907,918,11,884,1409,0.013
2244,task_2244,784,796,12,784,1238,0.007
2245,task_2245,1154,1168,14,1152,1357,0.012
2246,task_2246,1016,1026,10,1015,1218,0.013
2247,task_2247,961,972,11,959,1359,0.01
2248,task_2248,1389,1394,5,1389,1409,0.005
2249,task_2249,518,525,7,518,1306,0.005
2250,task_2250,722,732,10,722,1353,0.009
2251,task_2251,1217,1227,10,1217,1272,0.012
2252,task_2252,757,763,6,747,1293,0.008
2253,task_2253,479,484,5,479,726,0.013
2254,task_2254,1306,1317,11,1306,1392,0.008
2255,task_2255,933,945,12,933,1267,0.013
2256,task_2256,570,582,12,570,1368,0.01
2257,task_2257,982,988,6,982,1358,0.011
2258,task_2258,913,926,13,911,1118,0.006
2259,task_2259,662,676,14,660,744,0.009
2260,task_2260,658,671,13,657,1173,0.012
2261,task_2261,189,202,13,189,953,0.01
2262,task_2262,516,522,6,512,1265,0.011
2263,task_2263,112,124,12,112,322,0.007
2264,task_2264,86,93,7,86,587,0.009
2265,task_2265,981,986,5,981,1180,0.014
2266,task_2266,1070,1080,10,1069,1217,0.007
2267,task_2267,917,928,11,915,1161,0.008
2268,task_2268,665,678,13,665,867,0.014
2269,task_2269,1275,1285,10,1274,1369,0.005
2270,task_2270,97,109,12,97,144,0.006
2271,task_2271,898,905,7,898,989,0.01
2272,task_2272,564,576,12,564,672,0.009
2273,task_2273,704,717,13,703,1264,0.008
2274,task_2274,1092,1106,14,1091,1279,0.013
2275,task_2275,495,507,12,495,682,0.011
2276,task_2276,1152,1158,6,1152,1188,0.006
2277,task_2277,70,84,14,70,335,0.011
2278,task_2278,1380,1389,9,1380,1430,0.006
2279,task_2279,1353,1362,9,1353,1418,0.011
2280,task_2280,1027,1035,8,1027,1271,0.012
2281,task_2281,1212,1217,5,1212,1379,0.014
2282,task_2282,1383,1393,10,1383,1415,0.009
2283,task_2283,1266,1276,10,1266,1397,0.01
2284,task_2284,818,832,14,818,1134,0.007
2285,task_2285,1290,1302,12,1290,1383,0.013
2286,task_2286,1227,1238,11,1227,1427,0.013
2287,task_2287,700,706,6,700,1094,0.012
2288,task_2288,1381,1388,7,1381,1431,0.014
2289,task_2289,0,6,6,0,1030,0.014
2290,task_2290,663,677,14,660,773,0.014
2291,task_2291,1224,1238,14,1224,1288,0.01
2292,task_2292,806,811,5,801,1261,0.008
2293,task_2293,144,157,13,144,1003,0.006
2294,task_2294,219,228,9,219,345,0.008
2295,task_2295,802,812,10,802,926,0.005
2296,task_2296,1055,1062,7,1052,1269,0.014
2297,task_2297,105,114,9,102,629,0.012
2298,task_2298,486,496,10,483,1057,0.013
2299,task_2299,299,308,9,299,457,0.009
2300,task_2300,26,38,12,26,331,0.01
2301,task_2301,1237,1242,5,1237,1316,0.006
2302,task_2302,1379,1387,8,1379,1430,0.008
2303,task_2303,642,656,14,642,772,0.011
2304,task_2304,910,922,12,910,1132,0.011
2305,task_2305,509,517,8,506,828,0.009
2306,task_2306,635,641,6,635,1147,0.011
2307,task_2307,384,396,12,361,1407,0.005
2308,task_2308,1285,1291,6,1285,1375,0.008
2309,task_2309,1045,1056,11,1045,1132,0.008
2310,task_2310,338,350,12,338,716,0.009
2311,task_2311,446,454,8,446,663,0.009
2312,task_2312,666,675,9,665,921,0.01
2313,task_2313,166,172,6,166,873,0.012
2314,task_2314,384,392,8,383,1280,0.009
2315,task_2315,366,373,7,364,907,0.012
2316,task_2316,312,318,6,309,651,0.009
2317,task_2317,1203,1217,14,1203,1327,0.01
2318,task_2318,909,917,8,909,1076,0.012
2319,task_2319,1321,1332,11,1316,1438,0.007
2320,task_2320,817,831,14,803,1395,0.014
2321,task_2321,1323,1335,12,1323,1365,0.013
2322,task_2322,185,190,5,185,650,0.013
2323,task_2323,357,363,6,350,1259,0.007
2324,task_2324,970,976,6,970,1176,0.008
2325,task_2325,773,785,12,772,1109,0.007
2326,task_2326,1165,1176,11,1162,1343,0.012
2327,task_2327,21,27,6,21,974,0.012
2328,task_2328,393,402,9,391,1295,0.013
2329,task_2329,849,862,13,849,947,0.014
2330,task_2330,1255,1264,9,1248,1420,0.014
2331,task_2331,437,445,8,437,1255,0.008
2332,task_2332,771,776,5,770,1049,0.008
2333,task_2333,214,223,9,214,488,0.006
2334,task_2334,732,746,14,732,1404,0.01
2335,task_2335,845,856,11,845,1116,0.005
2336,task_2336,14,25,11,14,1146,0.012
2337,task_2337,1055,1069,14,1054,1193,0.009
2338,task_2338,365,370,5,365,849,0.012
2339,task_2339,1363,1369,6,1363,1419,0.013
2340,task_2340,1209,1216,7,1209,1305,0.008
2341,task_2341,248,256,8,248,402,0.007
2342,task_2342,938,949,11,938,1085,0.013
2343,task_2343,974,983,9,966,1370,0.009
2344,task_2344,354,365,11,354,729,0.005
2345,task_2345,1205,1219,14,1205,1259,0.014
2346,task_2346,1007,1016,9,1006,1378,0.011
2347,task_2347,552,561,9,550,996,0.007
2348,task_2348,213,227,14,213,711,0.005
2349,task_2349,1278,1288,10,1276,1326,0.013
2350,task_2350,390,396,6,390,664,0.011
2351,task_2351,704,714,10,702,1209,0.006
2352,task_2352,430,443,13,430,1385,0.014
2353,task_2353,704,716,12,702,1191,0.014
2354,task_2354,1009,1018,9,1008,1165,0.014
2355,task_2355,192,204,12,192,824,0.012
2356,task_2356,1373,1381,8,1373,1410,0.012
2357,task_2357,975,980,5,968,1411,0.013
2358,task_2358,291,304,13,291,354,0.008
2359,task_2359,1303,1317,14,1303,1358,0.01
2360,task_2360,347,354,7,347,1289,0.013
2361,task_2361,938,947,9,935,1202,0.014
2362,task_2362,604,610,6,604,844,0.011
2363,task_2363,1168,1175,7,1168,1269,0.01
2364,task_2364,868,873,5,865,1252,0.008
2365,task_2365,873,887,14,871,1288,0.014
2366,task_2366,591,604,13,591,766,0.013
2367,task_2367,1129,1143,14,1129,1382,0.011
2368,task_2368,1311,1318,7,1311,1380,0.007
2369,task_2369,8,16,8,8,450,0.009
2370,task_2370,818,823,5,818,1299,0.011
2371,task_2371,311,325,14,311,368,0.01
2372,task_2372,197,206,9,197,588,0.013
2373,task_2373,775,788,13,774,1033,0.01
2374,task_2374,806,817,11,798,1270,0.005
2375,task_2375,69,80,11,64,1256,0.011
2376,task_2376,1185,1199,14,1185,1367,0.01
2377,task_2377,3,9,6,3,498,0.008
2378,task_2378,4,18,14,4,756,0.009
2379,task_2379,1387,1393,6,1386,1425,0.007
2380,task_2380,1399,1407,8,1399,1425,0.007
2381,task_2381,289,294,5,289,704,0.013
2382,task_2382,352,364,12,350,816,0.007
2383,task_2383,838,845,7,836,1126,0.01
2384,task_2384,863,875,12,860,1417,0.008
2385,task_2385,876,884,8,876,950,0.011
2386,task_2386,1326,1336,10,1326,1354,0.012
2387,task_2387,371,383,12,363,1271,0.01
2388,task_2388,89,103,14,89,247,0.012
2389,task_2389,735,740,5,735,800,0.008
2390,task_2390,969,981,12,969,1154,0.008
2391,task_2391,1124,1132,8,1124,1348,0.009
2392,task_2392,957,965,8,957,1019,0.009
2393,task_2393,1246,1257,11,1246,1323,0.01
2394,task_2394,715,724,9,710,977,0.012
2395,task_2395,400,413,13,400,681,0.011
2396,task_2396,1095,1103,8,1095,1371,0.008
2397,task_2397,1016,1024,8,1014,1247,0.007
2398,task_2398,166,177,11,166,619,0.013
2399,task_2399,155,160,5,153,1041,0.012
2400,task_2400,873,878,5,873,1119,0.013
2401,task_2401,638,644,6,638,833,0.014
2402,task_2402,1291,1300,9,1291,1325,0.014
2403,task_2403,1258,1270,12,1258,1283,0.009
2404,task_2404,977,985,8,977,1177,0.012
2405,task_2405,301,309,8,299,803,0.011
2406,task_2406,656,665,9,656,1153,0.012
2407,task_2407,131,141,10,131,1341,0.006
2408,task_2408,851,860,9,851,871,0.011
2409,task_2409,649,656,7,649,686,0.009
2410,task_2410,1032,1037,5,1032,1048,0.012
2411,task_2411,767,779,12,766,1201,0.013
2412,task_2412,350,364,14,350,525,0.007
2413,task_2413,257,271,14,257,316,0.014
2414,task_2414,1224,1231,7,1224,1402,0.006
2415,task_2415,1250,1262,12,1250,1361,0.008
2416,task_2416,1386,1391,5,1386,1408,0.014
2417,task_2417,993,1006,13,993,1173,0.011
2418,task_2418,777,787,10,746,1416,0.012
2419,task_2419,0,7,7,0,930,0.013
2420,task_2420,712,721,9,712,880,0.005
2421,task_2421,930,940,10,929,1190,0.014
2422,task_2422,326,336,10,324,1022,0.007
2423,task_2423,1226,1231,5,1226,1392,0.005
2424,task_2424,345,354,9,345,834,0.007
2425,task_2425,760,767,7,760,825,0.005
2426,task_2426,1359,1367,8,1359,1390,0.008
2427,task_2427,307,321,14,302,1176,0.011
2428,task_2428,54,67,13,54,323,0.005
2429,task_2429,1025,1039,14,1025,1120,0.005
2430,task_2430,858,867,9,858,1360,0.007
2431,task_2431,407,414,7,407,1147,0.01
2432,task_2432,1333,1344,11,1333,1381,0.013
2433,task_2433,28,35,7,28,341,0.008
2434,task_2434,903,916,13,902,1155,0.005
2435,task_2435,787,798,11,786,1391,0.013
2436,task_2436,523,536,13,518,1427,0.012
2437,task_2437,546,554,8,546,980,0.012
2438,task_2438,1343,1354,11,1343,1378,0.012
2439,task_2439,1095,1105,10,1083,1411,0.008
2440,task_2440,11,20,9,11,1255,0.007
2441,task_2441,717,730,13,708,1293,0.013
2442,task_2442,227,234,7,227,550,0.009
2443,task_2443,463,468,5,463,890,0.01
2444,task_2444,800,805,5,800,830,0.011
2445,task_2445,684,695,11,682,941,0.008
2446,task_2446,536,547,11,536,1167,0.011
2447,task_2447,494,504,10,494,788,0.011
2448,task_2448,396,406,10,396,847,0.005
2449,task_2449,1027,1041,14,1023,1313,0.014
2450,task_2450,1080,1086,6,1050,1407,0.008
2451,task_2451,66,71,5,61,912,0.005
2452,task_2452,664,674,10,664,727,0.013
2453,task_2453,119,131,12,119,684,0.013
2454,task_2454,412,423,11,412,1230,0.01
2455,task_2455,1021,1026,5,1015,1386,0.008
2456,task_2456,111,121,10,110,710,0.013
2457,task_2457,830,843,13,830,1034,0.009
2458,task_2458,1110,1121,11,1110,1208,0.011
2459,task_2459,283,291,8,281,1275,0.013
2460,task_2460,1100,1112,12,1100,1261,0.012
2461,task_2461,55,61,6,55,1121,0.013
2462,task_2462,107,120,13,104,1316,0.005
2463,task_2463,291,302,11,291,1206,0.008
2464,task_2464,784,794,10,784,1268,0.011
2465,task_2465,84,92,8,84,308,0.007
2466,task_2466,1084,1098,14,1084,1212,0.007
2467,task_2467,1318,1327,9,1317,1390,0.011
2468,task_2468,587,593,6,587,1069,0.007
2469,task_2469,722,734,12,722,775,0.006
2470,task_2470,1403,1408,5,1392,1435,0.007
2471,task_2471,734,745,11,734,1431,0.013
2472,task_2472,946,960,14,944,1092,0.012
2473,task_2473,1389,1397,8,1387,1429,0.006
2474,task_2474,559,569,10,557,1159,0.011
2475,task_2475,1154,1164,10,1154,1288,0.009
2476,task_2476,772,777,5,772,1073,0.01
2477,task_2477,616,621,5,616,1009,0.009
2478,task_2478,545,559,14,545,655,0.008
2479,task_2479,357,366,9,357,720,0.01
2480,task_2480,801,808,7,797,1095,0.012
2481,task_2481,1289,1300,11,1288,1419,0.013
2482,task_2482,1090,1095,5,1090,1161,0.014
2483,task_2483,148,158,10,146,1214,0.012
2484,task_2484,1196,1209,13,1196,1244,0.014
2485,task_2485,45,58,13,45,302,0.007
2486,task_2486,1122,1127,5,1109,1416,0.01
2487,task_2487,417,430,13,366,1428,0.01
2488,task_2488,1301,1307,6,1301,1386,0.008
2489,task_2489,408,414,6,408,1106,0.007
2490,task_2490,481,486,5,481,572,0.007
2491,task_2491,985,995,10,984,1005,0.01
2492,task_2492,859,866,7,859,971,0.009
2493,task_2493,306,320,14,300,1120,0.013
2494,task_2494,402,408,6,402,439,0.006
2495,task_2495,309,316,7,309,494,0.013
2496,task_2496,31,40,9,31,1393,0.005
2497,task_2497,398,409,11,398,617,0.014
2498,task_2498,64,72,8,64,445,0.011
2499,task_2499,1107,1118,11,1107,1188,0.009
2500,task_2500,1230,1240,10,1230,1428,0.014
2501,task_2501,18,31,13,18,407,0.014
2502,task_2502,340,354,14,339,1244,0.009
2503,task_2503,743,756,13,740,1345,0.007
2504,task_2504,958,966,8,958,1146,0.008
2505,task_2505,245,252,7,245,1382,0.009
2506,task_2506,111,119,8,110,151,0.014
2507,task_2507,710,715,5,710,887,0.007
2508,task_2508,839,850,11,839,924,0.01
2509,task_2509,841,854,13,837,1286,0.006
2510,task_2510,963,969,6,916,1426,0.007
2511,task_2511,74,80,6,74,1249,0.007
2512,task_2512,887,894,7,887,1053,0.01
2513,task_2513,695,704,9,695,1374,0.014
2514,task_2514,651,664,13,651,948,0.008
2515,task_2515,1141,1146,5,1141,1319,0.013
2516,task_2516,822,827,5,822,899,0.007
2517,task_2517,1190,1201,11,1190,1400,0.012
2518,task_2518,1060,1070,10,1060,1172,0.009
2519,task_2519,597,606,9,597,1176,0.006
2520,task_2520,208,217,9,208,709,0.01
2521,task_2521,937,942,5,936,1169,0.011
2522,task_2522,425,438,13,425,1240,0.011
2523,task_2523,884,890,6,884,1197,0.013
2524,task_2524,975,982,7,973,1414,0.009
2525,task_2525,1111,1120,9,1111,1323,0.012
2526,task_2526,1152,1163,11,1152,1233,0.008
2527,task_2527,1381,1386,5,1370,1431,0.005
2528,task_2528,753,766,13,745,1205,0.011
2529,task_2529,1368,1380,12,1368,1392,0.014
2530,task_2530,119,129,10,119,882,0.007
2531,task_2531,284,291,7,281,1359,0.007
2532,task_2532,1389,1403,14,1389,1437,0.013
2533,task_2533,979,988,9,979,1108,0.012
2534,task_2534,1117,1123,6,996,1412,0.008
2535,task_2535,296,302,6,293,1149,0.012
2536,task_2536,685,691,6,664,1407,0.013
2537,task_2537,293,300,7,292,1026,0.008
2538,task_2538,658,672,14,650,1237,0.013
2539,task_2539,499,510,11,494,1221,0.007
2540,task_2540,758,771,13,755,1371,0.01
2541,task_2541,447,460,13,447,528,0.014
2542,task_2542,1184,1194,10,1184,1412,0.006
2543,task_2543,93,100,7,93,906,0.012
2544,task_2544,161,174,13,161,761,0.005
2545,task_2545,1056,1068,12,1030,1355,0.006
2546,task_2546,429,443,14,429,879,0.012
2547,task_2547,1394,1399,5,1394,1423,0.005
2548,task_2548,968,974,6,966,1320,0.01
2549,task_2549,1041,1047,6,1041,1197,0.011
2550,task_2550,631,639,8,631,1422,0.005
2551,task_2551,13,26,13,13,1226,0.012
2552,task_2552,1007,1020,13,1007,1371,0.011
2553,task_2553,1342,1349,7,1342,1432,0.012
2554,task_2554,843,849,6,843,866,0.008
2555,task_2555,1306,1318,12,1306,1400,0.009
2556,task_2556,456,465,9,456,852,0.009
2557,task_2557,917,926,9,915,1143,0.006
2558,task_2558,289,298,9,289,767,0.014
2559,task_2559,1341,1351,10,1341,1364,0.008
2560,task_2560,666,676,10,665,1018,0.01
2561,task_2561,425,433,8,425,796,0.008
2562,task_2562,528,536,8,528,1129,0.005
2563,task_2563,641,650,9,640,1423,0.013
2564,task_2564,114,124,10,112,747,0.011
2565,task_2565,4,15,11,4,1339,0.014
2566,task_2566,1308,1318,10,1306,1434,0.007
2567,task_2567,558,569,11,558,791,0.005
2568,task_2568,245,251,6,245,544,0.005
2569,task_2569,313,320,7,311,1150,0.01
2570,task_2570,676,683,7,674,1078,0.013
2571,task_2571,1194,1205,11,1194,1234,0.013
2572,task_2572,522,530,8,492,1361,0.005
2573,task_2573,1324,1338,14,1324,1439,0.01
2574,task_2574,449,459,10,449,813,0.01
2575,task_2575,632,643,11,632,1367,0.007
2576,task_2576,1158,1165,7,1158,1311,0.014
2577,task_2577,695,705,10,695,795,0.01
2578,task_2578,530,536,6,530,1260,0.008
2579,task_2579,710,722,12,710,891,0.01
2580,task_2580,1130,1138,8,1130,1241,0.01
2581,task_2581,290,296,6,290,749,0.008
2582,task_2582,260,265,5,260,585,0.01
2583,task_2583,965,977,12,965,1286,0.014
2584,task_2584,1045,1059,14,1045,1233,0.007
2585,task_2585,1277,1288,11,1277,1318,0.012
2586,task_2586,503,513,10,503,536,0.005
2587,task_2587,206,217,11,206,391,0.01
2588,task_2588,45,52,7,45,382,0.005
2589,task_2589,425,439,14,425,1125,0.007
2590,task_2590,228,241,13,228,398,0.011
2591,task_2591,849,857,8,849,990,0.008
2592,task_2592,197,210,13,197,318,0.01
2593,task_2593,736,746,10,735,883,0.007
2594,task_2594,992,1003,11,991,1207,0.011
2595,task_2595,708,718,10,708,849,0.006
2596,task_2596,948,958,10,929,1423,0.01
2597,task_2597,956,970,14,955,1229,0.007
2598,task_2598,521,526,5,519,732,0.008
2599,task_2599,862,871,9,840,1407,0.014
2600,task_2600,446,454,8,446,1390,0.008
2601,task_2601,59,72,13,59,523,0.008
2602,task_2602,805,813,8,789,1255,0.012
2603,task_2603,378,390,12,378,1038,0.012
2604,task_2604,343,356,13,341,1367,0.006
2605,task_2605,803,813,10,799,1228,0.014
2606,task_2606,80,87,7,80,1414,0.013
2607,task_2607,223,236,13,223,576,0.009
2608,task_2608,1066,1078,12,1061,1385,0.01
2609,task_2609,759,773,14,747,1413,0.014
2610,task_2610,798,809,11,798,854,0.014
2611,task_2611,226,239,13,224,1196,0.014
2612,task_2612,1069,1075,6,1069,1118,0.009
2613,task_2613,28,37,9,28,1233,0.006
2614,task_2614,830,841,11,830,860,0.014
2615,task_2615,97,104,7,94,1404,0.008
2616,task_2616,931,939,8,930,1318,0.01
2617,task_2617,497,502,5,496,947,0.014
2618,task_2618,1126,1139,13,1126,1278,0.007
2619,task_2619,905,919,14,889,1390,0.013
2620,task_2620,948,953,5,915,1422,0.008
2621,task_2621,294,307,13,294,965,0.014
2622,task_2622,351,357,6,351,523,0.01
2623,task_2623,183,193,10,183,891,0.011
2624,task_2624,366,371,5,365,1117,0.012
2625,task_2625,743,753,10,743,1206,0.009
2626,task_2626,907,921,14,742,1429,0.008
2627,task_2627,543,557,14,543,1131,0.012
2628,task_2628,52,66,14,52,1298,0.014
2629,task_2629,1166,1171,5,1166,1194,0.013
2630,task_2630,657,669,12,657,707,0.013
2631,task_2631,1116,1125,9,1116,1278,0.005
2632,task_2632,595,609,14,595,1014,0.012
2633,task_2633,974,981,7,967,1360,0.01
2634,task_2634,1099,1110,11,1099,1131,0.01
2635,task_2635,354,361,7,353,1072,0.006
2636,task_2636,581,586,5,581,953,0.01
2637,task_2637,850,856,6,834,1347,0.007
2638,task_2638,37,45,8,37,478,0.008
2639,task_2639,141,153,12,141,857,0.008
2640,task_2640,932,938,6,932,1062,0.008
2641,task_2641,723,730,7,723,1174,0.011
2642,task_2642,27,33,6,27,1002,0.006
2643,task_2643,1380,1386,6,1380,1413,0.007
2644,task_2644,470,481,11,470,524,0.007
2645,task_2645,1186,1191,5,1186,1325,0.008
2646,task_2646,1041,1051,10,1041,1208,0.005
2647,task_2647,1212,1219,7,1212,1331,0.01
2648,task_2648,565,572,7,564,1354,0.007
2649,task_2649,84,94,10,84,750,0.008
2650,task_2650,813,825,12,812,1359,0.007
2651,task_2651,254,263,9,254,1081,0.008
2652,task_2652,886,894,8,883,1298,0.013
2653,task_2653,690,703,13,690,771,0.011
2654,task_2654,646,654,8,646,924,0.005
2655,task_2655,78,87,9,78,1057,0.009
2656,task_2656,151,164,13,151,1292,0.012
2657,task_2657,1165,1172,7,1165,1362,0.005
2658,task_2658,739,753,14,738,821,0.011
2659,task_2659,257,265,8,257,812,0.009
2660,task_2660,111,125,14,110,822,0.009
2661,task_2661,1399,1409,10,1399,1432,0.005
2662,task_2662,1187,1196,9,1187,1299,0.005
2663,task_2663,866,878,12,865,1258,0.01
2664,task_2664,501,510,9,501,593,0.014
2665,task_2665,151,157,6,151,1127,0.011
2666,task_2666,1011,1025,14,1011,1185,0.011
2667,task_2667,561,575,14,561,650,0.014
2668,task_2668,1271,1279,8,1271,1304,0.006
2669,task_2669,850,864,14,845,1363,0.006
2670,task_2670,207,214,7,203,1424,0.008
2671,task_2671,741,751,10,738,1043,0.011
2672,task_2672,857,863,6,855,1306,0.014
2673,task_2673,619,630,11,619,873,0.01
2674,task_2674,492,499,7,492,1198,0.011
2675,task_2675,165,175,10,165,899,0.005
2676,task_2676,1239,1252,13,1239,1324,0.011
2677,task_2677,845,856,11,844,1101,0.01
2678,task_2678,544,554,10,544,1048,0.011
2679,task_2679,398,411,13,397,1089,0.01
2680,task_2680,706,711,5,703,1368,0.01
2681,task_2681,492,504,12,491,1166,0.014
2682,task_2682,275,283,8,275,850,0.012
2683,task_2683,581,588,7,581,878,0.012
2684,task_2684,370,376,6,362,1184,0.009
2685,task_2685,870,875,5,867,1367,0.008
2686,task_2686,1044,1051,7,1044,1248,0.013
2687,task_2687,107,115,8,106,1367,0.011
2688,task_2688,785,796,11,784,1270,0.012
2689,task_2689,124,138,14,123,589,0.011
2690,task_2690,1373,1378,5,1373,1411,0.01
2691,task_2691,306,316,10,298,1039,0.005
2692,task_2692,215,224,9,215,854,0.013
2693,task_2693,307,314,7,305,1178,0.007
2694,task_2694,1022,1027,5,1022,1149,0.012
2695,task_2695,207,221,14,207,435,0.005
2696,task_2696,1354,1362,8,1354,1389,0.014
2697,task_2697,1112,1119,7,1112,1317,0.009
2698,task_2698,732,741,9,732,1307,0.005
2699,task_2699,354,365,11,352,1058,0.008
2700,task_2700,1313,1325,12,1312,1360,0.014
2701,task_2701,698,704,6,697,1161,0.007
2702,task_2702,1299,1309,10,1293,1417,0.007
2703,task_2703,1254,1266,12,1254,1276,0.012
2704,task_2704,606,616,10,606,1184,0.005
2705,task_2705,226,240,14,226,435,0.011
2706,task_2706,1280,1286,6,1280,1334,0.009
2707,task_2707,893,901,8,892,1195,0.012
2708,task_2708,1189,1196,7,1189,1235,0.012
2709,task_2709,368,380,12,368,1014,0.007
2710,task_2710,405,412,7,395,1411,0.01
2711,task_2711,813,818,5,813,1215,0.008
2712,task_2712,576,584,8,576,965,0.012
2713,task_2713,954,962,8,954,1077,0.008
2714,task_2714,393,399,6,391,716,0.007
2715,task_2715,183,196,13,183,630,0.007
2716,task_2716,410,417,7,408,1349,0.008
2717,task_2717,1095,1105,10,1093,1343,0.014
2718,task_2718,599,609,10,599,1149,0.014
2719,task_2719,364,376,12,363,770,0.014
2720,task_2720,727,733,6,727,923,0.006
2721,task_2721,621,633,12,618,986,0.014
2722,task_2722,507,520,13,507,604,0.006
2723,task_2723,69,78,9,68,1358,0.008
2724,task_2724,1000,1014,14,1000,1063,0.01
2725,task_2725,564,577,13,560,1217,0.012
2726,task_2726,1036,1050,14,1032,1199,0.013
2727,task_2727,206,214,8,205,1302,0.014
2728,task_2728,533,541,8,533,741,0.007
2729,task_2729,850,863,13,842,1350,0.007
2730,task_2730,664,677,13,662,957,0.007
2731,task_2731,862,876,14,819,1391,0.013
2732,task_2732,384,394,10,381,1089,0.005
2733,task_2733,631,645,14,631,1174,0.012
2734,task_2734,101,112,11,101,787,0.005
2735,task_2735,279,288,9,279,589,0.01
2736,task_2736,31,45,14,31,552,0.007
2737,task_2737,539,549,10,539,1020,0.011
2738,task_2738,803,811,8,795,1232,0.013
2739,task_2739,1119,1127,8,1119,1203,0.013
2740,task_2740,1287,1297,10,1287,1390,0.006
2741,task_2741,764,777,13,760,1035,0.009
2742,task_2742,828,835,7,828,1022,0.013
2743,task_2743,1069,1078,9,1069,1179,0.008
2744,task_2744,681,695,14,674,1382,0.012
2745,task_2745,13,27,14,13,886,0.007
2746,task_2746,363,377,14,362,585,0.011
2747,task_2747,1221,1233,12,1221,1287,0.009
2748,task_2748,401,410,9,400,1082,0.014
2749,task_2749,681,694,13,681,720,0.007
2750,task_2750,716,727,11,709,1240,0.007
2751,task_2751,1331,1341,10,1331,1424,0.01
2752,task_2752,1158,1172,14,1156,1368,0.012
2753,task_2753,1290,1301,11,1290,1326,0.007
2754,task_2754,350,357,7,350,601,0.01
2755,task_2755,904,913,9,904,1017,0.011
2756,task_2756,1186,1195,9,1186,1329,0.014
2757,task_2757,886,900,14,884,1305,0.005
2758,task_2758,956,966,10,955,1410,0.009
2759,task_2759,744,756,12,742,1397,0.01
2760,task_2760,195,205,10,195,588,0.006
2761,task_2761,1117,1129,12,1111,1415,0.008
2762,task_2762,84,92,8,82,853,0.01
2763,task_2763,313,327,14,310,913,0.011
2764,task_2764,396,402,6,396,662,0.014
2765,task_2765,1369,1383,14,1368,1420,0.013
2766,task_2766,1088,1098,10,1087,1319,0.011
2767,task_2767,541,547,6,540,986,0.01
2768,task_2768,1343,1356,13,1343,1376,0.01
2769,task_2769,1064,1070,6,1056,1367,0.013
2770,task_2770,335,347,12,335,1062,0.008
2771,task_2771,1060,1065,5,1060,1226,0.006
2772,task_2772,1269,1281,12,1269,1379,0.008
2773,task_2773,26,38,12,26,933,0.014
2774,task_2774,401,407,6,401,705,0.013
2775,task_2775,1388,1399,11,1388,1415,0.013
2776,task_2776,714,720,6,714,835,0.011
2777,task_2777,678,685,7,678,1358,0.01
2778,task_2778,1381,1389,8,1371,1437,0.008
2779,task_2779,213,221,8,213,256,0.01
2780,task_2780,838,850,12,829,1222,0.012
2781,task_2781,1364,1375,11,1364,1424,0.012
2782,task_2782,1120,1131,11,1120,1258,0.006
2783,task_2783,1268,1279,11,1268,1331,0.008
2784,task_2784,757,763,6,756,1267,0.006
2785,task_2785,573,586,13,573,1218,0.011
2786,task_2786,266,272,6,264,1154,0.006
2787,task_2787,11,18,7,11,1320,0.005
2788,task_2788,886,895,9,884,1277,0.014
2789,task_2789,564,575,11,563,1029,0.011
2790,task_2790,1306,1313,7,1303,1368,0.013
2791,task_2791,147,154,7,147,622,0.009
2792,task_2792,1055,1064,9,1055,1209,0.011
2793,task_2793,218,226,8,218,617,0.013
2794,task_2794,1141,1150,9,1141,1232,0.011
2795,task_2795,120,130,10,120,1070,0.008
2796,task_2796,167,173,6,166,1096,0.011
2797,task_2797,274,280,6,274,1024,0.008
2798,task_2798,1087,1096,9,1083,1294,0.009
2799,task_2799,1143,1149,6,1143,1303,0.007
2800,task_2800,801,807,6,800,1222,0.006
2801,task_2801,502,513,11,502,1035,0.01
2802,task_2802,1127,1134,7,1127,1277,0.01
2803,task_2803,441,450,9,441,872,0.014
2804,task_2804,23,33,10,23,853,0.013
2805,task_2805,63,72,9,63,548,0.005
2806,task_2806,1081,1094,13,1081,1313,0.008
2807,task_2807,958,965,7,957,1110,0.007
2808,task_2808,316,328,12,297,1227,0.013
2809,task_2809,222,236,14,222,1168,0.007
2810,task_2810,1162,1170,8,1162,1273,0.008
2811,task_2811,1157,1168,11,1157,1344,0.014
2812,task_2812,921,928,7,916,1391,0.013
2813,task_2813,4,16,12,4,842,0.008
2814,task_2814,1238,1250,12,1238,1407,0.013
2815,task_2815,598,603,5,598,675,0.005
2816,task_2816,514,519,5,514,530,0.005
2817,task_2817,847,853,6,831,1308,0.007
2818,task_2818,437,442,5,437,1129,0.008
2819,task_2819,1143,1149,6,1142,1318,0.01
2820,task_2820,87,93,6,85,741,0.013
2821,task_2821,474,483,9,474,728,0.013
2822,task_2822,1176,1183,7,1176,1204,0.013
2823,task_2823,116,127,11,116,299,0.013
2824,task_2824,335,345,10,334,865,0.012
2825,task_2825,677,687,10,676,1247,0.012
2826,task_2826,1317,1331,14,1317,1350,0.006
2827,task_2827,866,878,12,865,1190,0.014
2828,task_2828,504,515,11,504,1051,0.013
2829,task_2829,688,694,6,688,1236,0.01
2830,task_2830,273,283,10,273,1176,0.008
2831,task_2831,1254,1268,14,1254,1381,0.012
2832,task_2832,213,218,5,213,988,0.013
2833,task_2833,1029,1036,7,1029,1050,0.012
2834,task_2834,780,793,13,780,1035,0.01
2835,task_2835,241,252,11,241,1340,0.013
2836,task_2836,610,616,6,610,926,0.011
2837,task_2837,617,625,8,617,1193,0.008
2838,task_2838,214,219,5,213,1153,0.008
2839,task_2839,114,127,13,113,1160,0.014
2840,task_2840,684,696,12,682,1215,0.01
2841,task_2841,343,349,6,339,1340,0.005
2842,task_2842,1375,1389,14,1369,1424,0.008
2843,task_2843,891,903,12,887,1345,0.01
2844,task_2844,1124,1135,11,1124,1164,0.01
2845,task_2845,282,287,5,282,1260,0.007
2846,task_2846,857,862,5,854,1327,0.006
2847,task_2847,1004,1013,9,1004,1043,0.006
2848,task_2848,1393,1405,12,1389,1437,0.009
2849,task_2849,95,105,10,95,416,0.01
2850,task_2850,1315,1323,8,1315,1407,0.014
2851,task_2851,241,253,12,241,1105,0.006
2852,task_2852,1103,1109,6,1102,1261,0.007
2853,task_2853,412,421,9,411,1385,0.012
2854,task_2854,1066,1078,12,1030,1382,0.012
2855,task_2855,812,817,5,812,1151,0.011
2856,task_2856,394,407,13,394,596,0.011
2857,task_2857,177,189,12,177,435,0.012
2858,task_2858,314,326,12,314,1140,0.012
2859,task_2859,532,542,10,531,777,0.006
2860,task_2860,537,543,6,537,1174,0.012
2861,task_2861,7,18,11,7,579,0.007
2862,task_2862,127,139,12,127,1387,0.014
2863,task_2863,1211,1222,11,1211,1377,0.009
2864,task_2864,211,222,11,211,928,0.013
2865,task_2865,1366,1374,8,1366,1417,0.005
2866,task_2866,1064,1074,10,1064,1261,0.006
2867,task_2867,767,774,7,762,1255,0.008
2868,task_2868,1019,1029,10,1019,1073,0.008
2869,task_2869,165,177,12,165,768,0.008
2870,task_2870,1074,1082,8,1011,1402,0.009
2871,task_2871,1066,1080,14,1066,1235,0.009
2872,task_2872,222,231,9,222,1252,0.008
2873,task_2873,55,64,9,55,585,0.006
2874,task_2874,156,168,12,156,600,0.005
2875,task_2875,1244,1254,10,1244,1333,0.014
2876,task_2876,458,466,8,458,906,0.014
2877,task_2877,694,705,11,693,1174,0.014
2878,task_2878,606,616,10,606,982,0.008
2879,task_2879,1334,1347,13,1333,1408,0.009
2880,task_2880,647,654,7,647,1023,0.005
2881,task_2881,969,978,9,969,1214,0.014
2882,task_2882,864,874,10,864,1053,0.012
2883,task_2883,333,340,7,333,1309,0.012
2884,task_2884,547,558,11,547,946,0.009
2885,task_2885,385,390,5,370,1417,0.005
2886,task_2886,658,667,9,652,1241,0.005
2887,task_2887,521,528,7,484,1332,0.012
2888,task_2888,907,915,8,904,1398,0.007
2889,task_2889,594,608,14,594,1237,0.006
2890,task_2890,980,986,6,972,1427,0.007
2891,task_2891,31,40,9,31,366,0.007
2892,task_2892,1198,1211,13,1198,1292,0.005
2893,task_2893,421,435,14,421,558,0.009
2894,task_2894,512,526,14,511,609,0.013
2895,task_2895,1294,1299,5,1294,1325,0.007
2896,task_2896,472,480,8,472,1095,0.014
2897,task_2897,88,97,9,86,1167,0.011
2898,task_2898,562,573,11,560,970,0.01
2899,task_2899,99,108,9,99,903,0.007
2900,task_2900,625,633,8,625,774,0.007
2901,task_2901,534,547,13,534,1160,0.008
2902,task_2902,296,301,5,296,353,0.01
2903,task_2903,6,13,7,6,945,0.009
2904,task_2904,913,926,13,911,1089,0.008
2905,task_2905,1338,1344,6,1335,1431,0.012
2906,task_2906,111,117,6,110,367,0.014
2907,task_2907,1064,1074,10,1063,1296,0.009
2908,task_2908,483,495,12,483,1045,0.011
2909,task_2909,1264,1278,14,1264,1407,0.01
2910,task_2910,705,710,5,702,1310,0.007
2911,task_2911,1168,1181,13,1168,1201,0.012
2912,task_2912,1154,1159,5,1154,1335,0.008
2913,task_2913,993,1007,14,991,1431,0.014
2914,task_2914,913,925,12,912,1104,0.011
2915,task_2915,1098,1111,13,1098,1145,0.012
2916,task_2916,906,914,8,906,1279,0.006
2917,task_2917,1097,1105,8,1097,1325,0.009
2918,task_2918,893,905,12,892,943,0.007
2919,task_2919,690,701,11,690,802,0.011
2920,task_2920,1228,1236,8,1228,1331,0.009
2921,task_2921,512,518,6,511,755,0.01
2922,task_2922,625,632,7,625,853,0.012
2923,task_2923,826,833,7,826,887,0.01
2924,task_2924,1120,1133,13,1120,1252,0.01
2925,task_2925,1248,1256,8,1248,1274,0.006
2926,task_2926,1295,1308,13,1293,1385,0.01
2927,task_2927,1056,1064,8,1056,1102,0.007
2928,task_2928,1163,1177,14,1163,1265,0.007
2929,task_2929,1248,1255,7,1248,1340,0.009
2930,task_2930,1090,1098,8,1090,1294,0.006
2931,task_2931,204,209,5,202,982,0.013
2932,task_2932,1381,1390,9,1378,1436,0.009
2933,task_2933,1348,1356,8,1348,1401,0.006
2934,task_2934,208,214,6,208,845,0.009
2935,task_2935,746,759,13,746,1083,0.011
2936,task_2936,334,340,6,334,473,0.01
2937,task_2937,1260,1266,6,1260,1374,0.007
2938,task_2938,380,385,5,367,1359,0.005
2939,task_2939,752,757,5,749,1064,0.008
2940,task_2940,320,332,12,311,1322,0.009
2941,task_2941,269,283,14,269,1149,0.008
2942,task_2942,921,930,9,911,1378,0.01
2943,task_2943,988,999,11,988,1030,0.008
2944,task_2944,187,199,12,187,1162,0.006
2945,task_2945,40,51,11,40,1344,0.005
2946,task_2946,583,591,8,583,978,0.012
2947,task_2947,534,546,12,534,1130,0.006
2948,task_2948,54,59,5,54,1161,0.005
2949,task_2949,388,393,5,388,535,0.014
2950,task_2950,528,542,14,528,1150,0.008
2951,task_2951,1218,1228,10,1218,1298,0.005
2952,task_2952,785,794,9,785,865,0.006
2953,task_2953,1345,1352,7,1345,1382,0.014
2954,task_2954,296,305,9,296,1260,0.006
2955,task_2955,885,893,8,885,922,0.005
2956,task_2956,1318,1324,6,1315,1420,0.012
2957,task_2957,615,628,13,615,846,0.014
2958,task_2958,1172,1181,9,1172,1364,0.005
2959,task_2959,392,401,9,391,413,0.013
2960,task_2960,542,548,6,542,869,0.007
2961,task_2961,162,176,14,162,1173,0.009
2962,task_2962,494,500,6,494,567,0.013
2963,task_2963,308,314,6,308,949,0.01
2964,task_2964,890,903,13,890,1283,0.011
2965,task_2965,901,906,5,897,1331,0.008
2966,task_2966,940,950,10,940,1283,0.01
2967,task_2967,176,187,11,176,585,0.012
2968,task_2968,1075,1080,5,1075,1379,0.005
2969,task_2969,751,759,8,750,916,0.007
2970,task_2970,773,785,12,761,1397,0.008
2971,task_2971,1400,1406,6,1390,1434,0.012
2972,task_2972,1152,1165,13,1152,1175,0.011
2973,task_2973,1278,1286,8,1278,1315,0.007
2974,task_2974,600,605,5,600,1320,0.009
2975,task_2975,828,838,10,828,871,0.012
2976,task_2976,287,300,13,287,1262,0.011
2977,task_2977,1306,1318,12,1304,1381,0.012
2978,task_2978,1166,1180,14,1166,1320,0.005
2979,task_2979,469,482,13,469,746,0.005
2980,task_2980,323,328,5,323,428,0.012
2981,task_2981,273,278,5,273,1305,0.005
2982,task_2982,567,574,7,566,933,0.011
2983,task_2983,1164,1175,11,1164,1335,0.005
2984,task_2984,585,597,12,585,1011,0.008
2985,task_2985,52,63,11,52,170,0.005
2986,task_2986,480,489,9,480,835,0.009
2987,task_2987,964,972,8,964,1022,0.014
2988,task_2988,144,158,14,144,380,0.012
2989,task_2989,1002,1011,9,1002,1303,0.011
2990,task_2990,987,1001,14,987,1257,0.01
2991,task_2991,1144,1151,7,1144,1203,0.006
2992,task_2992,1051,1060,9,1046,1304,0.012
2993,task_2993,72,84,12,72,419,0.008
2994,task_2994,1120,1126,6,1120,1399,0.006
2995,task_2995,1115,1129,14,1113,1267,0.009
2996,task_2996,1311,1318,7,1311,1349,0.005
2997,task_2997,634,641,7,634,1348,0.005
2998,task_2998,931,939,8,931,1285,0.012
2999,task_2999,377,384,7,369,1331,0.007
